campaign_group_member_criteria_regions_tables	0
member	region
rotbloods_occupation_decision_region_handover_wh2_main_aghol_wastelands_fortress_of_the_damned	wh2_main_aghol_wastelands_fortress_of_the_damned
rotbloods_occupation_decision_region_handover_wh2_main_aghol_wastelands_palace_of_princes	wh2_main_aghol_wastelands_palace_of_princes
rotbloods_occupation_decision_region_handover_wh2_main_aghol_wastelands_the_palace_of_ruin	wh2_main_aghol_wastelands_the_palace_of_ruin
rotbloods_occupation_decision_region_handover_wh2_main_albion_albion	wh2_main_albion_albion
rotbloods_occupation_decision_region_handover_wh2_main_albion_citadel_of_lead	wh2_main_albion_citadel_of_lead
rotbloods_occupation_decision_region_handover_wh2_main_albion_isle_of_wights	wh2_main_albion_isle_of_wights
rotbloods_occupation_decision_region_handover_wh2_main_ash_river_numas	wh2_main_ash_river_numas
rotbloods_occupation_decision_region_handover_wh2_main_ash_river_quatar	wh2_main_ash_river_quatar
rotbloods_occupation_decision_region_handover_wh2_main_ash_river_springs_of_eternal_life	wh2_main_ash_river_springs_of_eternal_life
rotbloods_occupation_decision_region_handover_wh2_main_atalan_mountains_eye_of_the_panther	wh2_main_atalan_mountains_eye_of_the_panther
rotbloods_occupation_decision_region_handover_wh2_main_atalan_mountains_martek	wh2_main_atalan_mountains_martek
rotbloods_occupation_decision_region_handover_wh2_main_atalan_mountains_vulture_mountain	wh2_main_atalan_mountains_vulture_mountain
rotbloods_occupation_decision_region_handover_wh2_main_avelorn_evershale	wh2_main_avelorn_evershale
rotbloods_occupation_decision_region_handover_wh2_main_avelorn_gaean_vale	wh2_main_avelorn_gaean_vale
rotbloods_occupation_decision_region_handover_wh2_main_avelorn_tor_saroir	wh2_main_avelorn_tor_saroir
rotbloods_occupation_decision_region_handover_wh2_main_blackspine_mountains_plain_of_dogs	wh2_main_blackspine_mountains_plain_of_dogs
rotbloods_occupation_decision_region_handover_wh2_main_blackspine_mountains_plain_of_spiders	wh2_main_blackspine_mountains_plain_of_spiders
rotbloods_occupation_decision_region_handover_wh2_main_blackspine_mountains_red_desert	wh2_main_blackspine_mountains_red_desert
rotbloods_occupation_decision_region_handover_wh2_main_caledor_tor_sethai	wh2_main_caledor_tor_sethai
rotbloods_occupation_decision_region_handover_wh2_main_caledor_vauls_anvil	wh2_main_caledor_vauls_anvil
rotbloods_occupation_decision_region_handover_wh2_main_charnel_valley_granite_massif	wh2_main_charnel_valley_granite_massif
rotbloods_occupation_decision_region_handover_wh2_main_charnel_valley_karag_orrud	wh2_main_charnel_valley_karag_orrud
rotbloods_occupation_decision_region_handover_wh2_main_chrace_elisia	wh2_main_chrace_elisia
rotbloods_occupation_decision_region_handover_wh2_main_chrace_tor_achare	wh2_main_chrace_tor_achare
rotbloods_occupation_decision_region_handover_wh2_main_coast_of_araby_al_haikk	wh2_main_coast_of_araby_al_haikk
rotbloods_occupation_decision_region_handover_wh2_main_coast_of_araby_copher	wh2_main_coast_of_araby_copher
rotbloods_occupation_decision_region_handover_wh2_main_coast_of_araby_fyrus	wh2_main_coast_of_araby_fyrus
rotbloods_occupation_decision_region_handover_wh2_main_cothique_mistnar	wh2_main_cothique_mistnar
rotbloods_occupation_decision_region_handover_wh2_main_cothique_tor_koruali	wh2_main_cothique_tor_koruali
rotbloods_occupation_decision_region_handover_wh2_main_crater_of_the_walking_dead_doom_glade	wh2_main_crater_of_the_walking_dead_doom_glade
rotbloods_occupation_decision_region_handover_wh2_main_crater_of_the_walking_dead_rasetra	wh2_main_crater_of_the_walking_dead_rasetra
rotbloods_occupation_decision_region_handover_wh2_main_deadwood_dargoth	wh2_main_deadwood_dargoth
rotbloods_occupation_decision_region_handover_wh2_main_deadwood_nagrar	wh2_main_deadwood_nagrar
rotbloods_occupation_decision_region_handover_wh2_main_deadwood_shagrath	wh2_main_deadwood_shagrath
rotbloods_occupation_decision_region_handover_wh2_main_deadwood_the_frozen_city	wh2_main_deadwood_the_frozen_city
rotbloods_occupation_decision_region_handover_wh2_main_devils_backbone_lahmia	wh2_main_devils_backbone_lahmia
rotbloods_occupation_decision_region_handover_wh2_main_devils_backbone_lybaras	wh2_main_devils_backbone_lybaras
rotbloods_occupation_decision_region_handover_wh2_main_devils_backbone_mahrak	wh2_main_devils_backbone_mahrak
rotbloods_occupation_decision_region_handover_wh2_main_doom_glades_hag_hall	wh2_main_doom_glades_hag_hall
rotbloods_occupation_decision_region_handover_wh2_main_doom_glades_ice_rock_gorge	wh2_main_doom_glades_ice_rock_gorge
rotbloods_occupation_decision_region_handover_wh2_main_doom_glades_temple_of_addaioth	wh2_main_doom_glades_temple_of_addaioth
rotbloods_occupation_decision_region_handover_wh2_main_doom_glades_vauls_anvil	wh2_main_doom_glades_vauls_anvil
rotbloods_occupation_decision_region_handover_wh2_main_eataine_angerrial	wh2_main_eataine_angerrial
rotbloods_occupation_decision_region_handover_wh2_main_eataine_lothern	wh2_main_eataine_lothern
rotbloods_occupation_decision_region_handover_wh2_main_eataine_shrine_of_asuryan	wh2_main_eataine_shrine_of_asuryan
rotbloods_occupation_decision_region_handover_wh2_main_eataine_tower_of_lysean	wh2_main_eataine_tower_of_lysean
rotbloods_occupation_decision_region_handover_wh2_main_ellyrion_tor_elyr	wh2_main_ellyrion_tor_elyr
rotbloods_occupation_decision_region_handover_wh2_main_ellyrion_whitefire_tor	wh2_main_ellyrion_whitefire_tor
rotbloods_occupation_decision_region_handover_wh2_main_great_desert_of_araby_bel_aliad	wh2_main_great_desert_of_araby_bel_aliad
rotbloods_occupation_decision_region_handover_wh2_main_great_desert_of_araby_black_tower_of_arkhan	wh2_main_great_desert_of_araby_black_tower_of_arkhan
rotbloods_occupation_decision_region_handover_wh2_main_great_desert_of_araby_el-kalabad	wh2_main_great_desert_of_araby_el-kalabad
rotbloods_occupation_decision_region_handover_wh2_main_great_desert_of_araby_pools_of_despair	wh2_main_great_desert_of_araby_pools_of_despair
rotbloods_occupation_decision_region_handover_wh2_main_great_mortis_delta_black_pyramid_of_nagash	wh2_main_great_mortis_delta_black_pyramid_of_nagash
rotbloods_occupation_decision_region_handover_wh2_main_headhunters_jungle_chupayotl	wh2_main_headhunters_jungle_chupayotl
rotbloods_occupation_decision_region_handover_wh2_main_headhunters_jungle_mangrove_coast	wh2_main_headhunters_jungle_mangrove_coast
rotbloods_occupation_decision_region_handover_wh2_main_headhunters_jungle_marks_of_the_old_ones	wh2_main_headhunters_jungle_marks_of_the_old_ones
rotbloods_occupation_decision_region_handover_wh2_main_headhunters_jungle_oyxl	wh2_main_headhunters_jungle_oyxl
rotbloods_occupation_decision_region_handover_wh2_main_heart_of_the_jungle_oreons_camp	wh2_main_heart_of_the_jungle_oreons_camp
rotbloods_occupation_decision_region_handover_wh2_main_hell_pit_hell_pit	wh2_main_hell_pit_hell_pit
rotbloods_occupation_decision_region_handover_wh2_main_huahuan_desert_chamber_of_visions	wh2_main_huahuan_desert_chamber_of_visions
rotbloods_occupation_decision_region_handover_wh2_main_huahuan_desert_sentinels_of_xeti	wh2_main_huahuan_desert_sentinels_of_xeti
rotbloods_occupation_decision_region_handover_wh2_main_huahuan_desert_the_golden_colossus	wh2_main_huahuan_desert_the_golden_colossus
rotbloods_occupation_decision_region_handover_wh2_main_iron_mountains_altar_of_ultimate_darkness	wh2_main_iron_mountains_altar_of_ultimate_darkness
rotbloods_occupation_decision_region_handover_wh2_main_iron_mountains_har_kaldra	wh2_main_iron_mountains_har_kaldra
rotbloods_occupation_decision_region_handover_wh2_main_iron_mountains_naggarond	wh2_main_iron_mountains_naggarond
rotbloods_occupation_decision_region_handover_wh2_main_iron_mountains_rackdo_gorge	wh2_main_iron_mountains_rackdo_gorge
rotbloods_occupation_decision_region_handover_wh2_main_ironfrost_glacier_dagraks_end	wh2_main_ironfrost_glacier_dagraks_end
rotbloods_occupation_decision_region_handover_wh2_main_ironfrost_glacier_ironfrost	wh2_main_ironfrost_glacier_ironfrost
rotbloods_occupation_decision_region_handover_wh2_main_isthmus_of_lustria_fallen_gates	wh2_main_isthmus_of_lustria_fallen_gates
rotbloods_occupation_decision_region_handover_wh2_main_isthmus_of_lustria_hexoatl	wh2_main_isthmus_of_lustria_hexoatl
rotbloods_occupation_decision_region_handover_wh2_main_isthmus_of_lustria_skeggi	wh2_main_isthmus_of_lustria_skeggi
rotbloods_occupation_decision_region_handover_wh2_main_isthmus_of_lustria_ziggurat_of_dawn	wh2_main_isthmus_of_lustria_ziggurat_of_dawn
rotbloods_occupation_decision_region_handover_wh2_main_jungles_of_green_mist_pillars_of_unseen_constellations	wh2_main_jungles_of_green_mist_pillars_of_unseen_constellations
rotbloods_occupation_decision_region_handover_wh2_main_jungles_of_green_mists_spektazuma	wh2_main_jungles_of_green_mists_spektazuma
rotbloods_occupation_decision_region_handover_wh2_main_jungles_of_green_mists_wellsprings_of_eternity	wh2_main_jungles_of_green_mists_wellsprings_of_eternity
rotbloods_occupation_decision_region_handover_wh2_main_kingdom_of_beasts_serpent_coast	wh2_main_kingdom_of_beasts_serpent_coast
rotbloods_occupation_decision_region_handover_wh2_main_kingdom_of_beasts_temple_of_skulls	wh2_main_kingdom_of_beasts_temple_of_skulls
rotbloods_occupation_decision_region_handover_wh2_main_kingdom_of_beasts_the_cursed_jungle	wh2_main_kingdom_of_beasts_the_cursed_jungle
rotbloods_occupation_decision_region_handover_wh2_main_land_of_assassins_lashiek	wh2_main_land_of_assassins_lashiek
rotbloods_occupation_decision_region_handover_wh2_main_land_of_assassins_palace_of_the_wizard_caliph	wh2_main_land_of_assassins_palace_of_the_wizard_caliph
rotbloods_occupation_decision_region_handover_wh2_main_land_of_assassins_sorcerers_islands	wh2_main_land_of_assassins_sorcerers_islands
rotbloods_occupation_decision_region_handover_wh2_main_land_of_the_dead_khemri	wh2_main_land_of_the_dead_khemri
rotbloods_occupation_decision_region_handover_wh2_main_land_of_the_dead_pyramid_of_nagash	wh2_main_land_of_the_dead_pyramid_of_nagash
rotbloods_occupation_decision_region_handover_wh2_main_land_of_the_dead_zandri	wh2_main_land_of_the_dead_zandri
rotbloods_occupation_decision_region_handover_wh2_main_land_of_the_dervishes_plain_of_tuskers	wh2_main_land_of_the_dervishes_plain_of_tuskers
rotbloods_occupation_decision_region_handover_wh2_main_land_of_the_dervishes_sudenburg	wh2_main_land_of_the_dervishes_sudenburg
rotbloods_occupation_decision_region_handover_wh2_main_laurelorn_forest_laurelorn_forest	wh2_main_laurelorn_forest_laurelorn_forest
rotbloods_occupation_decision_region_handover_wh2_main_misty_hills_the_black_pit	wh2_main_misty_hills_the_black_pit
rotbloods_occupation_decision_region_handover_wh2_main_misty_hills_wreckers_point	wh2_main_misty_hills_wreckers_point
rotbloods_occupation_decision_region_handover_wh2_main_nagarythe_shrine_of_khaine	wh2_main_nagarythe_shrine_of_khaine
rotbloods_occupation_decision_region_handover_wh2_main_nagarythe_tor_anlec	wh2_main_nagarythe_tor_anlec
rotbloods_occupation_decision_region_handover_wh2_main_nagarythe_tor_dranil	wh2_main_nagarythe_tor_dranil
rotbloods_occupation_decision_region_handover_wh2_main_northern_great_jungle_chaqua	wh2_main_northern_great_jungle_chaqua
rotbloods_occupation_decision_region_handover_wh2_main_northern_great_jungle_temple_of_tlencan	wh2_main_northern_great_jungle_temple_of_tlencan
rotbloods_occupation_decision_region_handover_wh2_main_northern_great_jungle_xahutec	wh2_main_northern_great_jungle_xahutec
rotbloods_occupation_decision_region_handover_wh2_main_northern_great_jungle_xlanhuapec	wh2_main_northern_great_jungle_xlanhuapec
rotbloods_occupation_decision_region_handover_wh2_main_northern_jungle_of_pahualaxa_macu_peaks	wh2_main_northern_jungle_of_pahualaxa_macu_peaks
rotbloods_occupation_decision_region_handover_wh2_main_northern_jungle_of_pahualaxa_port_reaver	wh2_main_northern_jungle_of_pahualaxa_port_reaver
rotbloods_occupation_decision_region_handover_wh2_main_northern_jungle_of_pahualaxa_shrine_of_sotek	wh2_main_northern_jungle_of_pahualaxa_shrine_of_sotek
rotbloods_occupation_decision_region_handover_wh2_main_northern_jungle_of_pahualaxa_swamp_town	wh2_main_northern_jungle_of_pahualaxa_swamp_town
rotbloods_occupation_decision_region_handover_wh2_main_obsidian_peaks_circle_of_destruction	wh2_main_obsidian_peaks_circle_of_destruction
rotbloods_occupation_decision_region_handover_wh2_main_obsidian_peaks_clar_karond	wh2_main_obsidian_peaks_clar_karond
rotbloods_occupation_decision_region_handover_wh2_main_obsidian_peaks_storag_kor	wh2_main_obsidian_peaks_storag_kor
rotbloods_occupation_decision_region_handover_wh2_main_obsidian_peaks_venom_glade	wh2_main_obsidian_peaks_venom_glade
rotbloods_occupation_decision_region_handover_wh2_main_saphery_port_elistor	wh2_main_saphery_port_elistor
rotbloods_occupation_decision_region_handover_wh2_main_saphery_tor_finu	wh2_main_saphery_tor_finu
rotbloods_occupation_decision_region_handover_wh2_main_saphery_tower_of_hoeth	wh2_main_saphery_tower_of_hoeth
rotbloods_occupation_decision_region_handover_wh2_main_sartosa_sartosa	wh2_main_sartosa_sartosa
rotbloods_occupation_decision_region_handover_wh2_main_sea_bay_of_corsairs	wh2_main_sea_bay_of_corsairs
rotbloods_occupation_decision_region_handover_wh2_main_sea_eastern_straits_of_the_great_ocean	wh2_main_sea_eastern_straits_of_the_great_ocean
rotbloods_occupation_decision_region_handover_wh2_main_sea_gulf_of_lustria	wh2_main_sea_gulf_of_lustria
rotbloods_occupation_decision_region_handover_wh2_main_sea_gulf_of_medes	wh2_main_sea_gulf_of_medes
rotbloods_occupation_decision_region_handover_wh2_main_sea_sea_of_chill	wh2_main_sea_sea_of_chill
rotbloods_occupation_decision_region_handover_wh2_main_sea_sea_of_dreams	wh2_main_sea_sea_of_dreams
rotbloods_occupation_decision_region_handover_wh2_main_sea_sea_of_dusk	wh2_main_sea_sea_of_dusk
rotbloods_occupation_decision_region_handover_wh2_main_sea_sea_of_malice	wh2_main_sea_sea_of_malice
rotbloods_occupation_decision_region_handover_wh2_main_sea_sea_of_serpents	wh2_main_sea_sea_of_serpents
rotbloods_occupation_decision_region_handover_wh2_main_sea_shark_straits	wh2_main_sea_shark_straits
rotbloods_occupation_decision_region_handover_wh2_main_sea_shifting_isles	wh2_main_sea_shifting_isles
rotbloods_occupation_decision_region_handover_wh2_main_sea_straits_of_fear	wh2_main_sea_straits_of_fear
rotbloods_occupation_decision_region_handover_wh2_main_sea_sunken_lands	wh2_main_sea_sunken_lands
rotbloods_occupation_decision_region_handover_wh2_main_sea_tarantula_coast	wh2_main_sea_tarantula_coast
rotbloods_occupation_decision_region_handover_wh2_main_sea_the_bleak_coast	wh2_main_sea_the_bleak_coast
rotbloods_occupation_decision_region_handover_wh2_main_sea_the_dragon_spine	wh2_main_sea_the_dragon_spine
rotbloods_occupation_decision_region_handover_wh2_main_sea_the_far_sea	wh2_main_sea_the_far_sea
rotbloods_occupation_decision_region_handover_wh2_main_sea_the_forbidding_coast	wh2_main_sea_the_forbidding_coast
rotbloods_occupation_decision_region_handover_wh2_main_sea_the_galleons_graveyard	wh2_main_sea_the_galleons_graveyard
rotbloods_occupation_decision_region_handover_wh2_main_sea_the_isles	wh2_main_sea_the_isles
rotbloods_occupation_decision_region_handover_wh2_main_sea_the_vampire_coast	wh2_main_sea_the_vampire_coast
rotbloods_occupation_decision_region_handover_wh2_main_sea_volcanic_islands	wh2_main_sea_volcanic_islands
rotbloods_occupation_decision_region_handover_wh2_main_shifting_sands_antoch	wh2_main_shifting_sands_antoch
rotbloods_occupation_decision_region_handover_wh2_main_shifting_sands_bhagar	wh2_main_shifting_sands_bhagar
rotbloods_occupation_decision_region_handover_wh2_main_shifting_sands_ka-sabar	wh2_main_shifting_sands_ka-sabar
rotbloods_occupation_decision_region_handover_wh2_main_skavenblight_skavenblight	wh2_main_skavenblight_skavenblight
rotbloods_occupation_decision_region_handover_wh2_main_solland_pfeildorf	wh2_main_solland_pfeildorf
rotbloods_occupation_decision_region_handover_wh2_main_solland_steingart	wh2_main_solland_steingart
rotbloods_occupation_decision_region_handover_wh2_main_southern_great_jungle_axlotl	wh2_main_southern_great_jungle_axlotl
rotbloods_occupation_decision_region_handover_wh2_main_southern_great_jungle_itza	wh2_main_southern_great_jungle_itza
rotbloods_occupation_decision_region_handover_wh2_main_southern_great_jungle_subatuun	wh2_main_southern_great_jungle_subatuun
rotbloods_occupation_decision_region_handover_wh2_main_southern_jungle_of_pahualaxa_floating_pyramid	wh2_main_southern_jungle_of_pahualaxa_floating_pyramid
rotbloods_occupation_decision_region_handover_wh2_main_southern_jungle_of_pahualaxa_monument_of_the_moon	wh2_main_southern_jungle_of_pahualaxa_monument_of_the_moon
rotbloods_occupation_decision_region_handover_wh2_main_southern_jungle_of_pahualaxa_pahuax	wh2_main_southern_jungle_of_pahualaxa_pahuax
rotbloods_occupation_decision_region_handover_wh2_main_southern_jungle_of_pahualaxa_the_high_sentinel	wh2_main_southern_jungle_of_pahualaxa_the_high_sentinel
rotbloods_occupation_decision_region_handover_wh2_main_southlands_jungle_golden_tower_of_the_gods	wh2_main_southlands_jungle_golden_tower_of_the_gods
rotbloods_occupation_decision_region_handover_wh2_main_southlands_jungle_teotiqua	wh2_main_southlands_jungle_teotiqua
rotbloods_occupation_decision_region_handover_wh2_main_southlands_worlds_edge_mountains_karak_zorn	wh2_main_southlands_worlds_edge_mountains_karak_zorn
rotbloods_occupation_decision_region_handover_wh2_main_southlands_worlds_edge_mountains_lost_plateau	wh2_main_southlands_worlds_edge_mountains_lost_plateau
rotbloods_occupation_decision_region_handover_wh2_main_southlands_worlds_edge_mountains_mount_arachnos	wh2_main_southlands_worlds_edge_mountains_mount_arachnos
rotbloods_occupation_decision_region_handover_wh2_main_spine_of_sotek_hualotal	wh2_main_spine_of_sotek_hualotal
rotbloods_occupation_decision_region_handover_wh2_main_spine_of_sotek_mine_of_the_bearded_skulls	wh2_main_spine_of_sotek_mine_of_the_bearded_skulls
rotbloods_occupation_decision_region_handover_wh2_main_spine_of_sotek_monument_of_izzatal	wh2_main_spine_of_sotek_monument_of_izzatal
rotbloods_occupation_decision_region_handover_wh2_main_the_black_coast_arnheim	wh2_main_the_black_coast_arnheim
rotbloods_occupation_decision_region_handover_wh2_main_the_black_coast_bleak_hold_fortress	wh2_main_the_black_coast_bleak_hold_fortress
rotbloods_occupation_decision_region_handover_wh2_main_the_black_flood_cragroth_deep	wh2_main_the_black_flood_cragroth_deep
rotbloods_occupation_decision_region_handover_wh2_main_the_black_flood_hag_graef	wh2_main_the_black_flood_hag_graef
rotbloods_occupation_decision_region_handover_wh2_main_the_black_flood_shroktak_mount	wh2_main_the_black_flood_shroktak_mount
rotbloods_occupation_decision_region_handover_wh2_main_the_black_flood_temple_of_khaine	wh2_main_the_black_flood_temple_of_khaine
rotbloods_occupation_decision_region_handover_wh2_main_the_broken_land_blacklight_tower	wh2_main_the_broken_land_blacklight_tower
rotbloods_occupation_decision_region_handover_wh2_main_the_broken_land_karond_kar	wh2_main_the_broken_land_karond_kar
rotbloods_occupation_decision_region_handover_wh2_main_the_broken_land_slavers_point	wh2_main_the_broken_land_slavers_point
rotbloods_occupation_decision_region_handover_wh2_main_the_chill_road_ashrak	wh2_main_the_chill_road_ashrak
rotbloods_occupation_decision_region_handover_wh2_main_the_chill_road_ghrond	wh2_main_the_chill_road_ghrond
rotbloods_occupation_decision_region_handover_wh2_main_the_chill_road_the_great_arena	wh2_main_the_chill_road_the_great_arena
rotbloods_occupation_decision_region_handover_wh2_main_the_clawed_coast_hoteks_column	wh2_main_the_clawed_coast_hoteks_column
rotbloods_occupation_decision_region_handover_wh2_main_the_clawed_coast_the_monoliths	wh2_main_the_clawed_coast_the_monoliths
rotbloods_occupation_decision_region_handover_wh2_main_the_clawed_coast_the_twisted_glade	wh2_main_the_clawed_coast_the_twisted_glade
rotbloods_occupation_decision_region_handover_wh2_main_the_creeping_jungle_temple_of_kara	wh2_main_the_creeping_jungle_temple_of_kara
rotbloods_occupation_decision_region_handover_wh2_main_the_creeping_jungle_tlanxla	wh2_main_the_creeping_jungle_tlanxla
rotbloods_occupation_decision_region_handover_wh2_main_the_creeping_jungle_tlaxtlan	wh2_main_the_creeping_jungle_tlaxtlan
rotbloods_occupation_decision_region_handover_wh2_main_the_galleons_graveyard	wh2_main_the_galleons_graveyard
rotbloods_occupation_decision_region_handover_wh2_main_the_road_of_skulls_har_ganeth	wh2_main_the_road_of_skulls_har_ganeth
rotbloods_occupation_decision_region_handover_wh2_main_the_road_of_skulls_kauark	wh2_main_the_road_of_skulls_kauark
rotbloods_occupation_decision_region_handover_wh2_main_the_road_of_skulls_spite_reach	wh2_main_the_road_of_skulls_spite_reach
rotbloods_occupation_decision_region_handover_wh2_main_the_road_of_skulls_the_black_pillar	wh2_main_the_road_of_skulls_the_black_pillar
rotbloods_occupation_decision_region_handover_wh2_main_tiranoc_tor_anroc	wh2_main_tiranoc_tor_anroc
rotbloods_occupation_decision_region_handover_wh2_main_tiranoc_whitepeak	wh2_main_tiranoc_whitepeak
rotbloods_occupation_decision_region_handover_wh2_main_titan_peaks_ancient_city_of_quintex	wh2_main_titan_peaks_ancient_city_of_quintex
rotbloods_occupation_decision_region_handover_wh2_main_titan_peaks_ironspike	wh2_main_titan_peaks_ironspike
rotbloods_occupation_decision_region_handover_wh2_main_titan_peaks_ssildra_tor	wh2_main_titan_peaks_ssildra_tor
rotbloods_occupation_decision_region_handover_wh2_main_titan_peaks_the_moon_shard	wh2_main_titan_peaks_the_moon_shard
rotbloods_occupation_decision_region_handover_wh2_main_vampire_coast_pox_marsh	wh2_main_vampire_coast_pox_marsh
rotbloods_occupation_decision_region_handover_wh2_main_vampire_coast_the_awakening	wh2_main_vampire_coast_the_awakening
rotbloods_occupation_decision_region_handover_wh2_main_vampire_coast_the_blood_swamps	wh2_main_vampire_coast_the_blood_swamps
rotbloods_occupation_decision_region_handover_wh2_main_volcanic_islands_fuming_serpent	wh2_main_volcanic_islands_fuming_serpent
rotbloods_occupation_decision_region_handover_wh2_main_volcanic_islands_the_star_tower	wh2_main_volcanic_islands_the_star_tower
rotbloods_occupation_decision_region_handover_wh2_main_western_jungles_cuexotl	wh2_main_western_jungles_cuexotl
rotbloods_occupation_decision_region_handover_wh2_main_western_jungles_tlaqua	wh2_main_western_jungles_tlaqua
rotbloods_occupation_decision_region_handover_wh2_main_yvresse_elessaeli	wh2_main_yvresse_elessaeli
rotbloods_occupation_decision_region_handover_wh2_main_yvresse_tor_yvresse	wh2_main_yvresse_tor_yvresse
rotbloods_occupation_decision_region_handover_wh_main_athel_loren_crag_halls	wh_main_athel_loren_crag_halls
rotbloods_occupation_decision_region_handover_wh_main_athel_loren_vauls_anvil	wh_main_athel_loren_vauls_anvil
rotbloods_occupation_decision_region_handover_wh_main_athel_loren_waterfall_palace	wh_main_athel_loren_waterfall_palace
rotbloods_occupation_decision_region_handover_wh_main_athel_loren_yn_edryl_korian	wh_main_athel_loren_yn_edryl_korian
rotbloods_occupation_decision_region_handover_wh_main_averland_averheim	wh_main_averland_averheim
rotbloods_occupation_decision_region_handover_wh_main_averland_grenzstadt	wh_main_averland_grenzstadt
rotbloods_occupation_decision_region_handover_wh_main_bastonne_et_montfort_castle_bastonne	wh_main_bastonne_et_montfort_castle_bastonne
rotbloods_occupation_decision_region_handover_wh_main_bastonne_et_montfort_montfort	wh_main_bastonne_et_montfort_montfort
rotbloods_occupation_decision_region_handover_wh_main_black_mountains_karak_angazhar	wh_main_black_mountains_karak_angazhar
rotbloods_occupation_decision_region_handover_wh_main_black_mountains_karak_hirn	wh_main_black_mountains_karak_hirn
rotbloods_occupation_decision_region_handover_wh_main_black_mountains_mighdal_vongalbarak	wh_main_black_mountains_mighdal_vongalbarak
rotbloods_occupation_decision_region_handover_wh_main_blightwater_deff_gorge	wh_main_blightwater_deff_gorge
rotbloods_occupation_decision_region_handover_wh_main_blightwater_karak_azgal	wh_main_blightwater_karak_azgal
rotbloods_occupation_decision_region_handover_wh_main_blightwater_kradtommen	wh_main_blightwater_kradtommen
rotbloods_occupation_decision_region_handover_wh_main_blightwater_misty_mountain	wh_main_blightwater_misty_mountain
rotbloods_occupation_decision_region_handover_wh_main_blood_river_valley_barag_dawazbag	wh_main_blood_river_valley_barag_dawazbag
rotbloods_occupation_decision_region_handover_wh_main_blood_river_valley_barak_varr	wh_main_blood_river_valley_barak_varr
rotbloods_occupation_decision_region_handover_wh_main_blood_river_valley_dok_karaz	wh_main_blood_river_valley_dok_karaz
rotbloods_occupation_decision_region_handover_wh_main_blood_river_valley_varenka_hills	wh_main_blood_river_valley_varenka_hills
rotbloods_occupation_decision_region_handover_wh_main_bordeleaux_et_aquitaine_aquitaine	wh_main_bordeleaux_et_aquitaine_aquitaine
rotbloods_occupation_decision_region_handover_wh_main_bordeleaux_et_aquitaine_bordeleaux	wh_main_bordeleaux_et_aquitaine_bordeleaux
rotbloods_occupation_decision_region_handover_wh_main_carcassone_et_brionne_brionne	wh_main_carcassone_et_brionne_brionne
rotbloods_occupation_decision_region_handover_wh_main_carcassone_et_brionne_castle_carcassonne	wh_main_carcassone_et_brionne_castle_carcassonne
rotbloods_occupation_decision_region_handover_wh_main_chaos_wastes	wh_main_chaos_wastes
rotbloods_occupation_decision_region_handover_wh_main_couronne_et_languille_couronne	wh_main_couronne_et_languille_couronne
rotbloods_occupation_decision_region_handover_wh_main_couronne_et_languille_languille	wh_main_couronne_et_languille_languille
rotbloods_occupation_decision_region_handover_wh_main_death_pass_iron_rock	wh_main_death_pass_iron_rock
rotbloods_occupation_decision_region_handover_wh_main_death_pass_karag_dron	wh_main_death_pass_karag_dron
rotbloods_occupation_decision_region_handover_wh_main_death_pass_karak_drazh	wh_main_death_pass_karak_drazh
rotbloods_occupation_decision_region_handover_wh_main_desolation_of_nagash_black_iron_mine	wh_main_desolation_of_nagash_black_iron_mine
rotbloods_occupation_decision_region_handover_wh_main_desolation_of_nagash_karak_azul	wh_main_desolation_of_nagash_karak_azul
rotbloods_occupation_decision_region_handover_wh_main_desolation_of_nagash_spitepeak	wh_main_desolation_of_nagash_spitepeak
rotbloods_occupation_decision_region_handover_wh_main_eastern_badlands_crooked_fang_fort	wh_main_eastern_badlands_crooked_fang_fort
rotbloods_occupation_decision_region_handover_wh_main_eastern_badlands_dringorackaz	wh_main_eastern_badlands_dringorackaz
rotbloods_occupation_decision_region_handover_wh_main_eastern_badlands_karak_eight_peaks	wh_main_eastern_badlands_karak_eight_peaks
rotbloods_occupation_decision_region_handover_wh_main_eastern_badlands_valayas_sorrow	wh_main_eastern_badlands_valayas_sorrow
rotbloods_occupation_decision_region_handover_wh_main_eastern_border_princes_akendorf	wh_main_eastern_border_princes_akendorf
rotbloods_occupation_decision_region_handover_wh_main_eastern_border_princes_matorca	wh_main_eastern_border_princes_matorca
rotbloods_occupation_decision_region_handover_wh_main_eastern_oblast_praag	wh_main_eastern_oblast_praag
rotbloods_occupation_decision_region_handover_wh_main_eastern_oblast_volksgrad	wh_main_eastern_oblast_volksgrad
rotbloods_occupation_decision_region_handover_wh_main_eastern_sylvania_castle_drakenhof	wh_main_eastern_sylvania_castle_drakenhof
rotbloods_occupation_decision_region_handover_wh_main_eastern_sylvania_eschen	wh_main_eastern_sylvania_eschen
rotbloods_occupation_decision_region_handover_wh_main_eastern_sylvania_waldenhof	wh_main_eastern_sylvania_waldenhof
rotbloods_occupation_decision_region_handover_wh_main_estalia_bilbali	wh_main_estalia_bilbali
rotbloods_occupation_decision_region_handover_wh_main_estalia_magritta	wh_main_estalia_magritta
rotbloods_occupation_decision_region_handover_wh_main_estalia_tobaro	wh_main_estalia_tobaro
rotbloods_occupation_decision_region_handover_wh_main_forest_of_arden_castle_artois	wh_main_forest_of_arden_castle_artois
rotbloods_occupation_decision_region_handover_wh_main_forest_of_arden_gisoreux	wh_main_forest_of_arden_gisoreux
rotbloods_occupation_decision_region_handover_wh_main_gianthome_mountains_khazid_bordkarag	wh_main_gianthome_mountains_khazid_bordkarag
rotbloods_occupation_decision_region_handover_wh_main_gianthome_mountains_kraka_drak	wh_main_gianthome_mountains_kraka_drak
rotbloods_occupation_decision_region_handover_wh_main_gianthome_mountains_sjoktraken	wh_main_gianthome_mountains_sjoktraken
rotbloods_occupation_decision_region_handover_wh_main_goromandy_mountains_baersonlings_camp	wh_main_goromandy_mountains_baersonlings_camp
rotbloods_occupation_decision_region_handover_wh_main_goromandy_mountains_frozen_landing	wh_main_goromandy_mountains_frozen_landing
rotbloods_occupation_decision_region_handover_wh_main_helspire_mountains_graeling_moot	wh_main_helspire_mountains_graeling_moot
rotbloods_occupation_decision_region_handover_wh_main_helspire_mountains_serpent_jetty	wh_main_helspire_mountains_serpent_jetty
rotbloods_occupation_decision_region_handover_wh_main_helspire_mountains_the_monolith_of_katam	wh_main_helspire_mountains_the_monolith_of_katam
rotbloods_occupation_decision_region_handover_wh_main_hochland_brass_keep	wh_main_hochland_brass_keep
rotbloods_occupation_decision_region_handover_wh_main_hochland_hergig	wh_main_hochland_hergig
rotbloods_occupation_decision_region_handover_wh_main_ice_tooth_mountains_doomkeep	wh_main_ice_tooth_mountains_doomkeep
rotbloods_occupation_decision_region_handover_wh_main_ice_tooth_mountains_icedrake_fjord	wh_main_ice_tooth_mountains_icedrake_fjord
rotbloods_occupation_decision_region_handover_wh_main_ice_tooth_mountains_longship_graveyard	wh_main_ice_tooth_mountains_longship_graveyard
rotbloods_occupation_decision_region_handover_wh_main_lyonesse_lyonesse	wh_main_lyonesse_lyonesse
rotbloods_occupation_decision_region_handover_wh_main_lyonesse_mousillon	wh_main_lyonesse_mousillon
rotbloods_occupation_decision_region_handover_wh_main_massif_orcal_massif_orcal	wh_main_massif_orcal_massif_orcal
rotbloods_occupation_decision_region_handover_wh_main_middenland_carroburg	wh_main_middenland_carroburg
rotbloods_occupation_decision_region_handover_wh_main_middenland_middenheim	wh_main_middenland_middenheim
rotbloods_occupation_decision_region_handover_wh_main_middenland_middenstag	wh_main_middenland_middenstag
rotbloods_occupation_decision_region_handover_wh_main_middenland_weismund	wh_main_middenland_weismund
rotbloods_occupation_decision_region_handover_wh_main_mountains_of_hel_aeslings_conclave	wh_main_mountains_of_hel_aeslings_conclave
rotbloods_occupation_decision_region_handover_wh_main_mountains_of_hel_altar_of_spawns	wh_main_mountains_of_hel_altar_of_spawns
rotbloods_occupation_decision_region_handover_wh_main_mountains_of_hel_winter_pyre	wh_main_mountains_of_hel_winter_pyre
rotbloods_occupation_decision_region_handover_wh_main_mountains_of_naglfari_naglfari_plain	wh_main_mountains_of_naglfari_naglfari_plain
rotbloods_occupation_decision_region_handover_wh_main_mountains_of_naglfari_varg_camp	wh_main_mountains_of_naglfari_varg_camp
rotbloods_occupation_decision_region_handover_wh_main_nordland_dietershafen	wh_main_nordland_dietershafen
rotbloods_occupation_decision_region_handover_wh_main_nordland_salzenmund	wh_main_nordland_salzenmund
rotbloods_occupation_decision_region_handover_wh_main_northern_grey_mountains_blackstone_post	wh_main_northern_grey_mountains_blackstone_post
rotbloods_occupation_decision_region_handover_wh_main_northern_grey_mountains_grung_zint	wh_main_northern_grey_mountains_grung_zint
rotbloods_occupation_decision_region_handover_wh_main_northern_grey_mountains_karak_ziflin	wh_main_northern_grey_mountains_karak_ziflin
rotbloods_occupation_decision_region_handover_wh_main_northern_oblast_fort_ostrosk	wh_main_northern_oblast_fort_ostrosk
rotbloods_occupation_decision_region_handover_wh_main_northern_oblast_fort_straghov	wh_main_northern_oblast_fort_straghov
rotbloods_occupation_decision_region_handover_wh_main_northern_worlds_edge_mountains_karak_ungor	wh_main_northern_worlds_edge_mountains_karak_ungor
rotbloods_occupation_decision_region_handover_wh_main_northern_worlds_edge_mountains_khazid_irkulaz	wh_main_northern_worlds_edge_mountains_khazid_irkulaz
rotbloods_occupation_decision_region_handover_wh_main_ostermark_bechafen	wh_main_ostermark_bechafen
rotbloods_occupation_decision_region_handover_wh_main_ostermark_essen	wh_main_ostermark_essen
rotbloods_occupation_decision_region_handover_wh_main_ostermark_mordheim	wh_main_ostermark_mordheim
rotbloods_occupation_decision_region_handover_wh_main_ostermark_nagenhof	wh_main_ostermark_nagenhof
rotbloods_occupation_decision_region_handover_wh_main_ostland_castle_von_rauken	wh_main_ostland_castle_von_rauken
rotbloods_occupation_decision_region_handover_wh_main_ostland_norden	wh_main_ostland_norden
rotbloods_occupation_decision_region_handover_wh_main_ostland_wolfenburg	wh_main_ostland_wolfenburg
rotbloods_occupation_decision_region_handover_wh_main_parravon_et_quenelles_parravon	wh_main_parravon_et_quenelles_parravon
rotbloods_occupation_decision_region_handover_wh_main_parravon_et_quenelles_quenelles	wh_main_parravon_et_quenelles_quenelles
rotbloods_occupation_decision_region_handover_wh_main_peak_pass_gnashraks_lair	wh_main_peak_pass_gnashraks_lair
rotbloods_occupation_decision_region_handover_wh_main_peak_pass_karak_kadrin	wh_main_peak_pass_karak_kadrin
rotbloods_occupation_decision_region_handover_wh_main_reikland_altdorf	wh_main_reikland_altdorf
rotbloods_occupation_decision_region_handover_wh_main_reikland_eilhart	wh_main_reikland_eilhart
rotbloods_occupation_decision_region_handover_wh_main_reikland_grunburg	wh_main_reikland_grunburg
rotbloods_occupation_decision_region_handover_wh_main_reikland_helmgart	wh_main_reikland_helmgart
rotbloods_occupation_decision_region_handover_wh_main_rib_peaks_grom_peak	wh_main_rib_peaks_grom_peak
rotbloods_occupation_decision_region_handover_wh_main_rib_peaks_mount_gunbad	wh_main_rib_peaks_mount_gunbad
rotbloods_occupation_decision_region_handover_wh_main_riv_reik	wh_main_riv_reik
rotbloods_occupation_decision_region_handover_wh_main_riv_talabec	wh_main_riv_talabec
rotbloods_occupation_decision_region_handover_wh_main_sea_gulf_of_kislev	wh_main_sea_gulf_of_kislev
rotbloods_occupation_decision_region_handover_wh_main_sea_kraken_sea	wh_main_sea_kraken_sea
rotbloods_occupation_decision_region_handover_wh_main_sea_lake	wh_main_sea_lake
rotbloods_occupation_decision_region_handover_wh_main_sea_middle_sea	wh_main_sea_middle_sea
rotbloods_occupation_decision_region_handover_wh_main_sea_sea_of_chaos	wh_main_sea_sea_of_chaos
rotbloods_occupation_decision_region_handover_wh_main_sea_sea_of_claws	wh_main_sea_sea_of_claws
rotbloods_occupation_decision_region_handover_wh_main_sea_southern_straits_of_the_great_ocean	wh_main_sea_southern_straits_of_the_great_ocean
rotbloods_occupation_decision_region_handover_wh_main_sea_the_black_gulf	wh_main_sea_the_black_gulf
rotbloods_occupation_decision_region_handover_wh_main_sea_the_frozen_sea	wh_main_sea_the_frozen_sea
rotbloods_occupation_decision_region_handover_wh_main_sea_the_great_ocean	wh_main_sea_the_great_ocean
rotbloods_occupation_decision_region_handover_wh_main_sea_the_pirate_coast	wh_main_sea_the_pirate_coast
rotbloods_occupation_decision_region_handover_wh_main_sea_tilean_sea	wh_main_sea_tilean_sea
rotbloods_occupation_decision_region_handover_wh_main_sea_unknown_seas	wh_main_sea_unknown_seas
rotbloods_occupation_decision_region_handover_wh_main_sea_western_straits_of_the_great_ocean	wh_main_sea_western_straits_of_the_great_ocean
rotbloods_occupation_decision_region_handover_wh_main_southern_badlands_agrul_migdhal	wh_main_southern_badlands_agrul_migdhal
rotbloods_occupation_decision_region_handover_wh_main_southern_badlands_galbaraz	wh_main_southern_badlands_galbaraz
rotbloods_occupation_decision_region_handover_wh_main_southern_badlands_gor_gazan	wh_main_southern_badlands_gor_gazan
rotbloods_occupation_decision_region_handover_wh_main_southern_badlands_gronti_mingol	wh_main_southern_badlands_gronti_mingol
rotbloods_occupation_decision_region_handover_wh_main_southern_grey_mountains_grimhold	wh_main_southern_grey_mountains_grimhold
rotbloods_occupation_decision_region_handover_wh_main_southern_grey_mountains_karak_azgaraz	wh_main_southern_grey_mountains_karak_azgaraz
rotbloods_occupation_decision_region_handover_wh_main_southern_grey_mountains_karak_norn	wh_main_southern_grey_mountains_karak_norn
rotbloods_occupation_decision_region_handover_wh_main_southern_oblast_fort_jakova	wh_main_southern_oblast_fort_jakova
rotbloods_occupation_decision_region_handover_wh_main_southern_oblast_kislev	wh_main_southern_oblast_kislev
rotbloods_occupation_decision_region_handover_wh_main_southern_oblast_zavastra	wh_main_southern_oblast_zavastra
rotbloods_occupation_decision_region_handover_wh_main_stirland_flensburg	wh_main_stirland_flensburg
rotbloods_occupation_decision_region_handover_wh_main_stirland_niedling	wh_main_stirland_niedling
rotbloods_occupation_decision_region_handover_wh_main_stirland_the_moot	wh_main_stirland_the_moot
rotbloods_occupation_decision_region_handover_wh_main_stirland_wurtbad	wh_main_stirland_wurtbad
rotbloods_occupation_decision_region_handover_wh_main_talabecland_kappelburg	wh_main_talabecland_kappelburg
rotbloods_occupation_decision_region_handover_wh_main_talabecland_kemperbad	wh_main_talabecland_kemperbad
rotbloods_occupation_decision_region_handover_wh_main_talabecland_krugenheim	wh_main_talabecland_krugenheim
rotbloods_occupation_decision_region_handover_wh_main_talabecland_talabheim	wh_main_talabecland_talabheim
rotbloods_occupation_decision_region_handover_wh_main_the_silver_road_karaz_a_karak	wh_main_the_silver_road_karaz_a_karak
rotbloods_occupation_decision_region_handover_wh_main_the_silver_road_mount_squighorn	wh_main_the_silver_road_mount_squighorn
rotbloods_occupation_decision_region_handover_wh_main_the_silver_road_the_pillars_of_grungni	wh_main_the_silver_road_the_pillars_of_grungni
rotbloods_occupation_decision_region_handover_wh_main_the_vaults_karak_bhufdar	wh_main_the_vaults_karak_bhufdar
rotbloods_occupation_decision_region_handover_wh_main_the_vaults_karak_izor	wh_main_the_vaults_karak_izor
rotbloods_occupation_decision_region_handover_wh_main_the_vaults_zarakzil	wh_main_the_vaults_zarakzil
rotbloods_occupation_decision_region_handover_wh_main_the_wasteland_aarnau	wh_main_the_wasteland_aarnau
rotbloods_occupation_decision_region_handover_wh_main_the_wasteland_gorssel	wh_main_the_wasteland_gorssel
rotbloods_occupation_decision_region_handover_wh_main_the_wasteland_marienburg	wh_main_the_wasteland_marienburg
rotbloods_occupation_decision_region_handover_wh_main_tilea_luccini	wh_main_tilea_luccini
rotbloods_occupation_decision_region_handover_wh_main_tilea_miragliano	wh_main_tilea_miragliano
rotbloods_occupation_decision_region_handover_wh_main_troll_country_erengrad	wh_main_troll_country_erengrad
rotbloods_occupation_decision_region_handover_wh_main_troll_country_zoishenk	wh_main_troll_country_zoishenk
rotbloods_occupation_decision_region_handover_wh_main_trollheim_mountains_bay_of_blades	wh_main_trollheim_mountains_bay_of_blades
rotbloods_occupation_decision_region_handover_wh_main_trollheim_mountains_sarl_encampment	wh_main_trollheim_mountains_sarl_encampment
rotbloods_occupation_decision_region_handover_wh_main_trollheim_mountains_the_tower_of_khrakk	wh_main_trollheim_mountains_the_tower_of_khrakk
rotbloods_occupation_decision_region_handover_wh_main_unknown_terrain	wh_main_unknown_terrain
rotbloods_occupation_decision_region_handover_wh_main_vanaheim_mountains_bjornlings_gathering	wh_main_vanaheim_mountains_bjornlings_gathering
rotbloods_occupation_decision_region_handover_wh_main_vanaheim_mountains_pack_ice_bay	wh_main_vanaheim_mountains_pack_ice_bay
rotbloods_occupation_decision_region_handover_wh_main_vanaheim_mountains_troll_fjord	wh_main_vanaheim_mountains_troll_fjord
rotbloods_occupation_decision_region_handover_wh_main_western_badlands_bitterstone_mine	wh_main_western_badlands_bitterstone_mine
rotbloods_occupation_decision_region_handover_wh_main_western_badlands_dragonhorn_mines	wh_main_western_badlands_dragonhorn_mines
rotbloods_occupation_decision_region_handover_wh_main_western_badlands_ekrund	wh_main_western_badlands_ekrund
rotbloods_occupation_decision_region_handover_wh_main_western_badlands_stonemine_tower	wh_main_western_badlands_stonemine_tower
rotbloods_occupation_decision_region_handover_wh_main_western_border_princes_myrmidens	wh_main_western_border_princes_myrmidens
rotbloods_occupation_decision_region_handover_wh_main_western_border_princes_zvorak	wh_main_western_border_princes_zvorak
rotbloods_occupation_decision_region_handover_wh_main_western_sylvania_castle_templehof	wh_main_western_sylvania_castle_templehof
rotbloods_occupation_decision_region_handover_wh_main_western_sylvania_fort_oberstyre	wh_main_western_sylvania_fort_oberstyre
rotbloods_occupation_decision_region_handover_wh_main_western_sylvania_schwartzhafen	wh_main_western_sylvania_schwartzhafen
rotbloods_occupation_decision_region_handover_wh_main_wissenland_nuln	wh_main_wissenland_nuln
rotbloods_occupation_decision_region_handover_wh_main_wissenland_pfeildorf	wh_main_wissenland_pfeildorf
rotbloods_occupation_decision_region_handover_wh_main_wissenland_wissenburg	wh_main_wissenland_wissenburg
rotbloods_occupation_decision_region_handover_wh_main_zhufbar_karag_dromar	wh_main_zhufbar_karag_dromar
rotbloods_occupation_decision_region_handover_wh_main_zhufbar_oakenhammer	wh_main_zhufbar_oakenhammer
rotbloods_occupation_decision_region_handover_wh_main_zhufbar_zhufbar	wh_main_zhufbar_zhufbar
rotbloods_occupation_decision_region_handover_wh2_main_aghol_wastelands_fortress_of_the_damned	wh2_main_aghol_wastelands_fortress_of_the_damned
rotbloods_occupation_decision_region_handover_wh2_main_dragon_isles_dragon_fang_mount	wh2_main_dragon_isles_dragon_fang_mount
rotbloods_occupation_decision_region_handover_wh2_main_dragon_isles_dread_rock	wh2_main_dragon_isles_dread_rock
rotbloods_occupation_decision_region_handover_wh2_main_dragon_isles_shattered_stone_isle	wh2_main_dragon_isles_shattered_stone_isle
rotbloods_occupation_decision_region_handover_wh2_main_gnoblar_country_flayed_rock	wh2_main_gnoblar_country_flayed_rock
rotbloods_occupation_decision_region_handover_wh2_main_gnoblar_country_haunted_forest	wh2_main_gnoblar_country_haunted_forest
rotbloods_occupation_decision_region_handover_wh2_main_gnoblar_country_pigbarter	wh2_main_gnoblar_country_pigbarter
rotbloods_occupation_decision_region_handover_wh2_main_the_broken_teeth_desolation_of_nagash	wh2_main_the_broken_teeth_desolation_of_nagash
rotbloods_occupation_decision_region_handover_wh2_main_the_broken_teeth_nagashizar	wh2_main_the_broken_teeth_nagashizar
rotbloods_occupation_decision_region_handover_wh2_main_the_plain_of_bones_ash_ridge_mountains	wh2_main_the_plain_of_bones_ash_ridge_mountains
rotbloods_occupation_decision_region_handover_wh2_main_the_plain_of_bones_darkhold	wh2_main_the_plain_of_bones_darkhold
rotbloods_occupation_decision_region_handover_wh2_main_the_plain_of_bones_the_fortress_of_vorag	wh2_main_the_plain_of_bones_the_fortress_of_vorag
rotbloods_occupation_decision_region_handover_wh2_main_the_wolf_lands_crookback_mountain	wh2_main_the_wolf_lands_crookback_mountain
rotbloods_occupation_decision_region_handover_wh2_main_the_wolf_lands_mount_greyhag	wh2_main_the_wolf_lands_mount_greyhag
rotbloods_occupation_decision_region_handover_wh2_main_the_wolf_lands_mount_silverspear	wh2_main_the_wolf_lands_mount_silverspear
rotbloods_occupation_decision_region_handover_wh2_main_northern_worlds_edge_mountains_karak_raziak	wh2_main_northern_worlds_edge_mountains_karak_raziak
rotbloods_occupation_decision_region_handover_wh2_main_marshes_of_madness_floating_village	wh2_main_marshes_of_madness_floating_village
rotbloods_occupation_decision_region_handover_wh2_main_marshes_of_madness_morgheim	wh2_main_marshes_of_madness_morgheim
rotbloods_occupation_decision_region_handover_wh2_main_badlands_glade	wh2_main_badlands_glade
rotbloods_occupation_decision_region_handover_wh2_main_lustria_glade	wh2_main_lustria_glade
rotbloods_occupation_decision_region_handover_wh2_main_naggaroth_glade	wh2_main_naggaroth_glade
rotbloods_occupation_decision_region_handover_wh2_main_northern_dark_lands_karak_vlag	wh2_main_northern_dark_lands_karak_vlag
rotbloods_occupation_decision_region_handover_wh2_main_northern_dark_lands_seep_gore	wh2_main_northern_dark_lands_seep_gore
rotbloods_occupation_decision_region_handover_wh2_main_northern_dark_lands_silver_pinnacle	wh2_main_northern_dark_lands_silver_pinnacle
rotbloods_occupation_decision_region_handover_wh2_main_old_world_glade	wh2_main_old_world_glade
rotbloods_occupation_decision_region_handover_wh2_main_southern_dark_lands_deadrock_gap	wh2_main_southern_dark_lands_deadrock_gap
rotbloods_occupation_decision_region_handover_wh2_main_southern_dark_lands_desolation_of_drakenmoor	wh2_main_southern_dark_lands_desolation_of_drakenmoor
rotbloods_occupation_decision_region_handover_wh2_main_vor_lustria_glade	wh2_main_vor_lustria_glade
rotbloods_occupation_decision_region_handover_wh2_main_vor_naggaroth_glade	wh2_main_vor_naggaroth_glade
rotbloods_occupation_decision_region_handover_wh2_main_vor_the_chill_road_atorak	wh2_main_vor_the_chill_road_atorak
