Loc PackedFile	1
key	text	tooltip
character_skills_localised_name_grudgebringers_campaign_quartermaster	Mercenary Heroes	false
character_skills_localised_description_grudgebringers_campaign_quartermaster	The Grudgebringers, victors of countless battles and veterans of many campaigns.	false
character_skills_localised_name_grudge_volley_of_arrows	Hail of Arrows	false
character_skills_localised_description_grudge_volley_of_arrows	Ready your bows! Nock! Mark! Draw! LOOOOOOOSE!!!	false
character_skills_localised_name_grudge_volley_of_dark_arrows	Hellrain	false
character_skills_localised_description_grudge_volley_of_dark_arrows	Nothing affects morale better than a hot rain of flaming arrows.	false
character_skills_localised_name_grudge_arrow_of_kurnous	Rage of the Forest	false
character_skills_localised_description_grudge_arrow_of_kurnous	When the arrow flies farther, it may kill sooner, which is vital in the Hunt.	false
character_skills_localised_name_grudge_skill_shrapnel_shot	Shrapnel Shot	false
character_skills_localised_description_grudge_skill_shrapnel_shot	If the enemy infantry is near, give 'em a punch.	false
character_skills_localised_name_grudge_skill_pepperpot	Pepperpot	false
character_skills_localised_description_grudge_skill_pepperpot	There are too many of them! Load our mortar with a bunch of dwarven grenades!	false
character_skills_localised_name_magic_ice_shield_of_cold	Shield of Cold	false
character_skills_localised_description_magic_ice_shield_of_cold	This spell creates a frozen shield that protects the chosen friendly regiment from any damage.	false
character_skills_localised_name_magic_ice_frost_blade	Frost Blade	false
character_skills_localised_description_magic_ice_frost_blade	A sparkling blade of ice forms in the target's hand, a precise magical weapon.	false
character_skills_localised_name_magic_ice_crisping_cold	Crisping Cold	false
character_skills_localised_description_magic_ice_crisping_cold	An unnatural cold invigorates friendly forces, making their movements faster and more accurate.	false
character_skills_localised_name_magic_ice_shattering_frost	Shattering Frost	false
character_skills_localised_description_magic_ice_shattering_frost	The sudden frost shakles movements of the target, shattering it's armour and turning it to a crumbly glass	false
character_skills_localised_name_magic_ice_chill	Chill	false
character_skills_localised_description_magic_ice_chill	Touch leaves a gleaming frost behind. The air within the immediate area drops to freezing for the duration of the spell	false
character_skills_localised_name_skill_all_magic_ice_cold	Unnatural Cold	false
character_skills_localised_description_skill_all_magic_ice_cold	The bond of ice wizard with nature is so powerful, that cold winds hinder enemy movements every time he casts a spell	false
character_skills_localised_name_magic_ice_blinding_blizzard	Blinding Blizzard	false
character_skills_localised_description_magic_ice_blinding_blizzard	A rapid snow blizzard emerges in enemy ranks blinding enemy soldiers and interfering their fire.	false
character_skills_localised_name_magic_ice_ice_shards	Ice Shards	false
character_skills_localised_description_magic_ice_ice_shards	Sharp icicles spring from the mage's hand in the direction of the target, causing multiple wounds as they pierce and impale their targets.	false
character_skills_localised_name_magic_ice_storm_strike	Storm Strike	false
character_skills_localised_description_magic_ice_storm_strike	Channels mighty flows of magic into a howling gale of cold. Anyone between the caster and his target is slashed by wind-whipped ice shards.	false
character_skills_localised_name_magic_ice_chill_blast	Chill Blast	false
character_skills_localised_description_magic_ice_chill_blast	With a single breath, the caster blows a freezing gale at anyone in front of him within 48 yards	false
character_skills_localised_name_magic_ice_ice_blizzard	Ice Blizzard	false
character_skills_localised_description_magic_ice_ice_blizzard	A swirling flurry of snow and ice rises from the land, freezing and blinding all in its path.	false
character_skills_localised_name_magic_ice_tempest	Biting Wind	false
character_skills_localised_description_magic_ice_tempest	A furious blizzard stirs up around a nearby enemy target, stopping them in their tracks. The troops are temporarily immobilized by the strong winds and biting cold, rendering them unable to move and causing severe damage.	false
character_skills_localised_name_magic_ice_hailstorm	Hailstorm	false
character_skills_localised_description_magic_ice_hailstorm	Channels Ice Magic upwards, forming large chunks of ice that fall to the ground with horrifying speed.	false
character_skills_localised_name_skill_all_magic_ice_winter	Winter Rage	false
character_skills_localised_description_skill_all_magic_ice_winter	When Ice Mage cast a spell the winter itself comes to help him, halving enemy's magic resistance.	false
character_skills_localised_name_grudge_skill_attack_main1	Cavalry Assault	false
character_skills_localised_name_grudge_skill_attack_main2	Saddle-Born	false
character_skills_localised_name_grudge_skill_attack_side1	Constant Training	false
character_skills_localised_name_grudge_skill_attack_side2	Regular Training	false
character_skills_localised_name_grudge_skill_attack_side3	Stable Training	false
character_skills_localised_name_grudge_skill_attack_starter	Good Attacker	false
character_skills_localised_name_grudge_skill_damage_main1	Forged Blades	false
character_skills_localised_name_grudge_skill_damage_main2	Exotic Blades	false
character_skills_localised_name_grudge_skill_damage_side1	Constant Training	false
character_skills_localised_name_grudge_skill_damage_side2	Regular Training	false
character_skills_localised_name_grudge_skill_damage_side3	Stable Training	false
character_skills_localised_name_grudge_skill_damage_starter	Mercenary Training	false
character_skills_localised_name_grudge_skill_defence_main1	Mounted Defense	false
character_skills_localised_name_grudge_skill_defence_main2	Cavalry Bulwark	false
character_skills_localised_name_grudge_skill_defence_side1	Constant Training	false
character_skills_localised_name_grudge_skill_defence_side2	Regular Training	false
character_skills_localised_name_grudge_skill_defence_side3	Stable Training	false
character_skills_localised_name_grudge_skill_defence_starter	Good Defender	false
character_skills_localised_name_grudge_skill_armour_main1	Crafted Heavy Armour	false
character_skills_localised_name_grudge_skill_armour_main2	Masterpiece Armour	false
character_skills_localised_name_grudge_skill_armour_side1	Fine Armour	false
character_skills_localised_name_grudge_skill_armour_side2	Armour Enhancements	false
character_skills_localised_name_grudge_skill_armour_side3	Good Armour	false
character_skills_localised_name_grudge_skill_armour_starter	Simple Armour	false
character_skills_localised_name_grudge_skill_speed_main1	Sprinter	false
character_skills_localised_name_grudge_skill_speed_main2	Sprint Mastery	false
character_skills_localised_name_grudge_skill_speed_side1	Constant Training	false
character_skills_localised_name_grudge_skill_speed_side2	Regular Training	false
character_skills_localised_name_grudge_skill_speed_side3	Stable Training	false
character_skills_localised_name_grudge_skill_speed_starter	Initial Training	false
character_skills_localised_name_grudge_skill_charge_main1	Master of Charge	false
character_skills_localised_name_grudge_skill_charge_main2	Paragon of Charge	false
character_skills_localised_name_grudge_skill_charge_side1	Constant Training	false
character_skills_localised_name_grudge_skill_charge_side2	Regular Training	false
character_skills_localised_name_grudge_skill_charge_side3	Stable Training	false
character_skills_localised_name_grudge_skill_charge_starter	Initial Training	false
character_skills_localised_name_grudge_skill_deadly_onslaught	Deadly Onslaught	false
character_skills_localised_name_grudge_skill_heroic_killing_blow	Killing Blow	false
character_skills_localised_name_grudge_skill_foe-seeker	Foe-Seeker	false
character_skills_localised_name_grudge_skill_slippery	Slippery	false
character_skills_localised_name_grudge_skill_faiths_bastion	Bastion	false
character_skills_localised_name_grudge_skill_stand_your_ground	Stand Your Ground!	false
character_skills_localised_name_grudge_skill_feint_and_riposte	Feint & Riposte	false
character_skills_localised_name_grudge_skill_rally	Rally!	false
character_skills_localised_name_grudge_skill_rune_of_hearth_&_home	Rune of Hearth & Home	false
character_skills_localised_name_grudge_skill_rune_of_oath_&_steel	Rune of Oath & Steel	false
character_skills_localised_name_grudge_skill_damping	Damping	false
character_skills_localised_name_grudge_skill_strike_the_runes	Strike the Runes	false
character_skills_localised_name_grudge_skill_forgefire	Forgefire	false
character_skills_localised_name_grudge_skill_rune_of_wrath_&_ruin	Rune of Wrath & Ruin	false
character_skills_localised_name_grudge_skill_rune_of_striking	Rune of Striking	false
character_skills_localised_name_grudge_skill_rune_of_might	Rune of Might	false
character_skills_localised_name_grudge_skill_rune_of_parrying	Rune of Parrying	false
character_skills_localised_name_grudge_skill_rune_of_fury	Rune of Fury	false
character_skills_localised_name_grudge_skill_rune_of_negation	Rune of Negation	false
character_skills_localised_name_grudge_skill_morale1	Indomitable	false
character_skills_localised_name_grudge_skill_morale2	Conviction	false
character_skills_localised_name_grudge_skill_morale3	Persistent	false
character_skills_localised_name_grudge_skill_hold_the_line	Hold the Line!	false
character_skills_localised_name_grudge_skill_soothsaying	Brass-lunged	false
character_skills_localised_name_grudge_skill_self_augury	Augury	false
character_skills_localised_name_grudge_skill_inspiring_presence	Exemplar	false
character_skills_localised_name_grudge_skill_benediction	Benediction	false
character_skills_localised_name_grudge_skill_missile_ward	Missile Warding	false
character_skills_localised_name_grudge_skill_magic_ward	Magic Warding	false
character_skills_localised_description_grudge_skill_attack_main1	Only through training and experience do these men find mastery of mounted combat.	false
character_skills_localised_description_grudge_skill_attack_main2	It's as if they were born in the saddle and have never left its embrace.	false
character_skills_localised_description_grudge_skill_attack_side1	A good mercenary trains always.	false
character_skills_localised_description_grudge_skill_attack_side2	A good mercenary trains always.	false
character_skills_localised_description_grudge_skill_attack_side3	A good mercenary trains always.	false
character_skills_localised_description_grudge_skill_attack_starter	A good mercenary trains always.	false
character_skills_localised_description_grudge_skill_damage_main1	These weapons are far superior to the mass-produced imperial steel.	false
character_skills_localised_description_grudge_skill_damage_main2	After many campaigns in faraway lands, all manner of strange blades are wielded, forged by men, dwarfs and elves.	false
character_skills_localised_description_grudge_skill_damage_side1	A good mercenary trains always.	false
character_skills_localised_description_grudge_skill_damage_side2	A good mercenary trains always.	false
character_skills_localised_description_grudge_skill_damage_side3	A good mercenary trains always.	false
character_skills_localised_description_grudge_skill_damage_starter	Good mercenaries train with constant drills and exercises and the Grudgebringer Cavalry even more so under Bernhardt. 	false
character_skills_localised_description_grudge_skill_defence_main1	It's a truly difficult art to wield a sword and shield from horseback.	false
character_skills_localised_description_grudge_skill_defence_main2	These men have no fear, they charge into the thick of battle and doggedly keep on fighting.	false
character_skills_localised_description_grudge_skill_defence_side1	A good mercenary trains always.	false
character_skills_localised_description_grudge_skill_defence_side2	A good mercenary trains always.	false
character_skills_localised_description_grudge_skill_defence_side3	A good mercenary trains always.	false
character_skills_localised_description_grudge_skill_defence_starter	A good mercenary trains always.	false
character_skills_localised_description_grudge_skill_armour_main1	Specially crafted to allow for the best protection and manoeuvrability.	false
character_skills_localised_description_grudge_skill_armour_main2	Forged by the greatest dwarven smiths.	false
character_skills_localised_description_grudge_skill_armour_side1	Good armour for veteran mercenary.	false
character_skills_localised_description_grudge_skill_armour_side2	Good armour for veteran mercenary.	false
character_skills_localised_description_grudge_skill_armour_side3	Good armour for veteran mercenary.	false
character_skills_localised_description_grudge_skill_armour_starter	Worn, but still good armour.	false
character_skills_localised_description_grudge_skill_speed_main1	This one can run at a very high speed.	false
character_skills_localised_description_grudge_skill_speed_main2	This one shows outstanding speed.	false
character_skills_localised_description_grudge_skill_speed_side1	A good mercenary trains always.	false
character_skills_localised_description_grudge_skill_speed_side2	A good mercenary trains always.	false
character_skills_localised_description_grudge_skill_speed_side3	A good mercenary trains always.	false
character_skills_localised_description_grudge_skill_speed_starter	A good mercenary trains always.	false
character_skills_localised_description_grudge_skill_charge_main1	This one achieved a true mastery in the art of war	false
character_skills_localised_description_grudge_skill_charge_main2	The one who reach unachievable mastery is called paragon.	false
character_skills_localised_description_grudge_skill_charge_side1	A good mercenary trains always.	false
character_skills_localised_description_grudge_skill_charge_side2	A good mercenary trains always.	false
character_skills_localised_description_grudge_skill_charge_side3	A good mercenary trains always.	false
character_skills_localised_description_grudge_skill_charge_starter	A good mercenary trains always.	false
character_skills_localised_description_grudge_skill_deadly_onslaught	The war is endless. The cycle of charging, clashing, and bloody hand-to-hand fighting is without end. It will never stop.	false
character_skills_localised_description_grudge_skill_heroic_killing_blow	There are powerful beings who can decapitate a dragon or plunge a sword into the heart of a gryphon in one mighty strike.	false
character_skills_localised_description_grudge_skill_foe-seeker	From one bloodied, lifeless corpse to the next, this one is always looking for the next adversary to best.	false
character_skills_localised_description_grudge_skill_slippery	This one can't be cornered or pinned, he just slips away.	false
character_skills_localised_description_grudge_skill_faiths_bastion	The faith of this one is so strong that protects him from any harm.	false
character_skills_localised_description_grudge_skill_stand_your_ground	Best attack is defence.	false
character_skills_localised_description_grudge_skill_feint_and_riposte	Every stroke is precisely made and finds it's mark perfectly.	false
character_skills_localised_description_grudge_skill_rally	Rally to my banner, and we shall bathe the plains with the blood of our enemies!	false
character_skills_localised_description_grudge_skill_rune_of_hearth_&_home	Invoking the Rune of Hearth and Home stirs a Dwarf's pride in his Hold, Clan and Ancestors.	false
character_skills_localised_description_grudge_skill_rune_of_oath_&_steel	Armour inscribed with the Rune of Oath & Steel will not bend or buckle.	false
character_skills_localised_description_grudge_skill_damping	The Dwarfs' natural anti-magic resistance is amplified to dampen the Winds of Magic.	false
character_skills_localised_description_grudge_skill_strike_the_runes	A Runesmith may 'strike the runes' - a metaphor for refusing to let them cool, which reduces their potency.	false
character_skills_localised_description_grudge_skill_forgefire	The fire of a runesmith's forge burn brighter and hotter, it's blessing upon an ally's weapons increase their potency.	false
character_skills_localised_description_grudge_skill_rune_of_wrath_&_ruin	The Rune of Wrath&Ruin causes the earth to crack, venting forth fire and sulphur.	false
character_skills_localised_description_grudge_skill_rune_of_striking	The Rune of Striking causes weapon to hit the foe's most vulnerable area with an uncanny precision.	false
character_skills_localised_description_grudge_skill_rune_of_might	A dwarf, wielding a weapon bearing the Rune of Might can fell a giant.	false
character_skills_localised_description_grudge_skill_rune_of_parrying	A weapon with this rune moves to block incoming attacks, making it's wielder extremely hard to hit.	false
character_skills_localised_description_grudge_skill_rune_of_fury	A weapon holding thhis rune almost jumping out of their wielder's hands towards the foe.	false
character_skills_localised_description_grudge_skill_rune_of_negation	This powerful rune protects any ally in range from magic.	false
character_skills_localised_description_grudge_skill_morale1	The iron will and indomitable presence of this leader ensures that his followers will remain steadfast against the peril they face.	false
character_skills_localised_description_grudge_skill_morale2	Such is this one's conviction that others have no choice but to believe.	false
character_skills_localised_description_grudge_skill_morale3	Nothing can break his persistance.	false
character_skills_localised_description_grudge_skill_hold_the_line	Those in command of the ranks will issue their commands with a ferocious bark, expecting instant obedience.	false
character_skills_localised_description_grudge_skill_soothsaying	Speaking words of power or faith can alter perceptions on the battlefield.	false
character_skills_localised_description_grudge_skill_self_augury	An omen, a sign - this being knows things and any who follow will share their glory.	false
character_skills_localised_description_grudge_skill_inspiring_presence	There are Lords that radiate power, confidence and fear, inspiring their followers to great or terrible acts.	false
character_skills_localised_description_grudge_skill_benediction	This honourable man inspires all allies around him.	false
character_skills_localised_description_grudge_skill_missile_ward	The relentless drive and fury of the Hammer, harnessed for the protection of this wardï¿½s bearer.	false
character_skills_localised_description_grudge_skill_magic_ward	Knowledge can be used as a shield against magical attack.	false
character_skills_localised_name_grudge_skill_missile_range	Improved Arrow Shape	false
character_skills_localised_name_grudge_skill_missile_damage	Bow Training	false
character_skills_localised_name_grudge_skill_missile_apdamage	Armor-Piercing Tip	false
character_skills_localised_name_grudge_skill_fire_at_will	Fire At Will	false
character_skills_localised_name_grudge_skill_missile_reload	Fleet Fingers	false
character_skills_localised_name_grudge_skill_missile_ammo	Enlarged Quivers	false
character_skills_localised_name_grudge_skill_missile_range_damage	Bow Mastery	false
character_skills_localised_name_grudge_skill_darken_the_skies	Darken the Skies	false
character_skills_localised_name_grudge_skill_missile_accuracy	Snipers	false
character_skills_localised_name_grudge_skill_increased_powder	Increased Powder	false
character_skills_localised_name_grudge_skill_enhanced_cartridge	Enhanced Cartridge	false
character_skills_localised_name_grudge_skill_hardened_bullets	Hardened Bullets	false
character_skills_localised_name_grudge_skill_bandolier	Better Bandoliers	false
character_skills_localised_name_grudge_skill_standardised_firing_drill	Firing Drill	false
character_skills_localised_name_grudge_skill_requisition	Ammo Requisition	false
character_skills_localised_name_grudge_skill_arms_dealer	Arms Dealer	false
character_skills_localised_name_grudge_skill_triangulation	Triangulation	false
character_skills_localised_name_grudge_skill_smoke_bomb	Smoke Bomb	false
character_skills_localised_name_grudge_skill_ballistics_calibration	Ballistics Calibration	false
character_skills_localised_name_grudge_skill_extra_powder	Extra Powder	false
character_skills_localised_name_grudge_skill_defensive_coordinator	Defensive Coordinator	false
character_skills_localised_name_grudge_skill_ballistics_instructor	Ballistics Instructor	false
character_skills_localised_name_grudge_skill_grudge_sapper	Master Sapper	false
character_skills_localised_name_grudge_skill_standardized_shells	Standardized Shells	false
character_skills_localised_name_grudge_skill_master_gunner	Master Gunner	false
character_skills_localised_name_grudge_skill_art_damage	Enhanced Gunpowder	false
character_skills_localised_name_grudge_skill_art_range	Standardized Barrels	false
character_skills_localised_name_grudge_skill_art_extra_reload	Artillery Crew Training	false
character_skills_localised_name_grudge_skill_art_ammunition	Ammo Carts	false
character_skills_localised_name_grudge_skill_art_piercing_shells	Hardened Cannonballs	false
character_skills_localised_name_grudge_skill_art_accurate	Constant Battle Training	false
character_skills_localised_name_grudge_skill_art_explosion	Improved Bombs	false
character_skills_localised_name_grudge_skill_art_apexplosion	Enhanced Bombs	false
character_skills_localised_name_grudge_skill_art_speed	Wide Weels	false
character_skills_localised_description_grudge_skill_missile_range	Increased missile range	false
character_skills_localised_description_grudge_skill_missile_damage	Increased missile damage	false
character_skills_localised_description_grudge_skill_missile_apdamage	Increased missile armour piercing damage	false
character_skills_localised_description_grudge_skill_fire_at_will	Grants skill: Fire at Will!	false
character_skills_localised_description_grudge_skill_missile_reload	Quick reload	false
character_skills_localised_description_grudge_skill_missile_ammo	Increased ammunition	false
character_skills_localised_description_grudge_skill_missile_range_damage	Increased range & damage	false
character_skills_localised_description_grudge_skill_darken_the_skies	Grants skill: Darken the Skies!, replaces skill Fire at Will!	false
character_skills_localised_description_grudge_skill_missile_accuracy	Improved accuracy	false
character_skills_localised_description_grudge_skill_increased_powder	Increased firearms damage	false
character_skills_localised_description_grudge_skill_enhanced_cartridge	Firearms reload time reduction	false
character_skills_localised_description_grudge_skill_hardened_bullets	Increased firearms armour piercing damage	false
character_skills_localised_description_grudge_skill_bandolier	Increased firearms ammunition	false
character_skills_localised_description_grudge_skill_standardised_firing_drill	Skill Standardized Firing Drill	false
character_skills_localised_description_grudge_skill_requisition	Skill Requisition	false
character_skills_localised_description_grudge_skill_arms_dealer	Skill Arms Dealer	false
character_skills_localised_description_grudge_skill_triangulation	Skill Triangulation	false
character_skills_localised_description_grudge_skill_smoke_bomb	Skill Smoke Bomb	false
character_skills_localised_description_grudge_skill_ballistics_calibration	Ballistics Calibration	false
character_skills_localised_description_grudge_skill_extra_powder	Extra Powder	false
character_skills_localised_description_grudge_skill_defensive_coordinator	Defensive Coordinator	false
character_skills_localised_description_grudge_skill_ballistics_instructor	Ballistics Instructor	false
character_skills_localised_description_grudge_skill_grudge_sapper	Grudge Sapper	false
character_skills_localised_description_grudge_skill_standardized_shells	Standardized Shells	false
character_skills_localised_description_grudge_skill_master_gunner	Master Gunner	false
character_skills_localised_description_grudge_skill_art_damage	Increased artillery damage	false
character_skills_localised_description_grudge_skill_art_range	Increased artillery range	false
character_skills_localised_description_grudge_skill_art_extra_reload	Artillery reload reduction	false
character_skills_localised_description_grudge_skill_art_ammunition	Increased artillery ammunition	false
character_skills_localised_description_grudge_skill_art_piercing_shells	Piercing Shells	false
character_skills_localised_description_grudge_skill_art_accurate	Increased artillery accuracy	false
character_skills_localised_description_grudge_skill_art_explosion	Increased explosion damage	false
character_skills_localised_description_grudge_skill_art_apexplosion	Increased armour piercing explosion damage	false
character_skills_localised_description_grudge_skill_art_speed	Increased artillery speed	false
character_skills_localised_name_grudge_skill_bst_champion_defensive_1	Defensive Stance	false
character_skills_localised_description_grudge_skill_bst_champion_defensive_1	Make the tiger leave his forest.	false
character_skills_localised_name_grudge_skill_bst_champion_defensive_2	Masterful Defensive Stance	false
character_skills_localised_description_grudge_skill_bst_champion_defensive_2	Make the tiger leave his forest.	false
character_skills_localised_name_grudge_skill_bst_champion_offensive_1	Offensive Stance	false
character_skills_localised_description_grudge_skill_bst_champion_offensive_1	Offense is the best defense.	false
character_skills_localised_name_grudge_skill_bst_champion_offensive_2	Masterful Offensive Stance	false
character_skills_localised_description_grudge_skill_bst_champion_offensive_2	Offense is the best defense.	false
character_skills_localised_name_grudge_skill_mercenary	Mercenary	false
character_skills_localised_description_grudge_skill_mercenary	Till green and inexperienced this one serves for a penny, but at higher levels his service costs much more.	false
character_skills_localised_name_grudge_skill_regiment_size	Hardened Regimental Commander	false
character_skills_localised_description_grudge_skill_regiment_size	Increases the the unit size of Bernhardt's personal cavalry unit.	false
character_skills_localised_name_grudge_skill_bernhardt_bonus_vs_men	Masterful Tactics vs Men	false
character_skills_localised_name_grudge_skill_bernhardt_bonus_vs_dwarves	Masterful Tactics vs Dwarves	false
character_skills_localised_name_grudge_skill_bernhardt_bonus_vs_undead	Masterful Tactics vs Undead	false
character_skills_localised_name_grudge_skill_bernhardt_bonus_vs_chaos	Masterful Tactics vs Chaos	false
character_skills_localised_name_grudge_skill_bernhardt_bonus_vs_beastmen	Masterful Tactics vs Beastmen	false
character_skills_localised_name_grudge_skill_bernhardt_bonus_vs_skaven	Masterful Tactics vs Skaven	false
character_skills_localised_name_grudge_skill_bernhardt_bonus_vs_greenskins	Masterful Tactics vs Greenskins	false
character_skills_localised_name_grudge_skill_bernhardt_bonus_vs_dark_elves	Masterful Tactics vs Dark Elves	false
character_skills_localised_name_grudge_skill_bernhardt_bonus_vs_lizardmen	Masterful Tactics vs Lizardmen	false
character_skills_localised_name_grudge_skill_bernhardt_bonus_vs_high_elves	Masterful Tactics vs High Elves	false
character_skills_localised_name_grudge_skill_bernhardt_bonus_vs_wood_elves	Masterful Tactics vs Wood Elves	false
character_skills_localised_name_grudge_skill_swiftness_of_itzl	Unstoppable Charge	false
character_skills_localised_name_grudge_skill_verminous_valour	Decisive Battle	false
character_skills_localised_description_grudge_skill_bernhardt_bonus_vs_men	Countless battles teach mercenaries to fight with different kinds of enemies.	false
character_skills_localised_description_grudge_skill_bernhardt_bonus_vs_dwarves	Countless battles teach mercenaries to fight with different kinds of enemies.	false
character_skills_localised_description_grudge_skill_bernhardt_bonus_vs_undead	Countless battles teach mercenaries to fight with different kinds of enemies.	false
character_skills_localised_description_grudge_skill_bernhardt_bonus_vs_chaos	Countless battles teach mercenaries to fight with different kinds of enemies.	false
character_skills_localised_description_grudge_skill_bernhardt_bonus_vs_beastmen	Countless battles teach mercenaries to fight with different kinds of enemies.	false
character_skills_localised_description_grudge_skill_bernhardt_bonus_vs_skaven	Countless battles teach mercenaries to fight with different kinds of enemies.	false
character_skills_localised_description_grudge_skill_bernhardt_bonus_vs_greenskins	Countless battles teach mercenaries to fight with different kinds of enemies.	false
character_skills_localised_description_grudge_skill_bernhardt_bonus_vs_dark_elves	Countless battles teach mercenaries to fight with different kinds of enemies.	false
character_skills_localised_description_grudge_skill_bernhardt_bonus_vs_lizardmen	Countless battles teach mercenaries to fight with different kinds of enemies.	false
character_skills_localised_description_grudge_skill_bernhardt_bonus_vs_high_elves	Countless battles teach mercenaries to fight with different kinds of enemies.	false
character_skills_localised_description_grudge_skill_bernhardt_bonus_vs_wood_elves	Countless battles teach mercenaries to fight with different kinds of enemies.	false
character_skills_localised_description_grudge_skill_swiftness_of_itzl	Nobody can intervene the charge of this men, when they have their target.	false
character_skills_localised_description_grudge_skill_verminous_valour	The leader calls his allies to the last, decisive battle.	false
character_skills_localised_name_grudge_skill_fire_ward	Immunity to Fire	false
character_skills_localised_description_grudge_skill_fire_ward	This skill grants the character immunity to fire.	false
character_skills_localised_name_grudge_skill_horn_of_urgok	Horn of Urgok	false
character_skills_localised_description_grudge_skill_horn_of_urgok	This enchanted horn has the power to panic enemies and calm friendly troops with a single blast. When sounded, all enemy regiments within earshot may flee and all fleeing friendly regiments within range will rally themselves.	false
character_skills_localised_name_grudge_skill_grudgebringer_sword	Grudgebringer Sword	false
character_skills_localised_name_grudge_skill_hellfire_sword	Hellfire Sword	false
character_skills_localised_name_grudge_skill_storm_sword	Storm Sword	false
character_skills_localised_name_grudge_skill_runefang	Runefang	false
character_skills_localised_name_grudge_skill_enchanted_shield	Enchanted Shield	false
character_skills_localised_name_grudge_skill_shield_of_ptolos	Shield of Ptolos	false
character_skills_localised_name_grudge_skill_spelleater_shield	Spelleater Shield	false
character_skills_localised_name_grudge_skill_dragonhelm	Dragonhelm	false
character_skills_localised_name_grudge_skill_wand_of_jet	Wand of Jet	false
character_skills_localised_name_grudge_skill_banner_of_arcane_warding	Banner of Arcane Warding	false
character_skills_localised_name_grudge_skill_banner_of_wrath	Banner of Wrath	false
character_skills_localised_name_grudge_skill_banner_of_defiance	Banner of Defiance	false
character_skills_localised_description_grudge_skill_grudgebringer_sword	This mighty sword has runes inscribed along the blade by a Bright magic Wizard Lord. In hand-to-hand combat the wielder strikes more accurately and ferociously against his enemies. In addition a fireball may be cast from the sword.	false
character_skills_localised_description_grudge_skill_hellfire_sword	This sword is enchanted with the energy of Bright magic. Its magical power may be cast when the wielder is in melee, unleashing a fiery blast which wounds any troops in the vicinity.	false
character_skills_localised_description_grudge_skill_storm_sword	This mighty sword channels the energy of Celestial magic through its blade. In hand-to-hand combat a successful strike wounds the enemy automatically, regardless of any armour he may be wearing. When the wielder is in melee it may be cast, summoning multiple lightning bolts from the sky which strike the enemy regiment.	false
character_skills_localised_description_grudge_skill_runefang	Forged by a great Dwarf runesmith as a gift to the Empire, this sword has powerful Dwarf runes carved upon its blade. The sword strikes with such force it penetrates all armour, and any undead troops hit by the sword suffer twice the normal damage.	false
character_skills_localised_description_grudge_skill_enchanted_shield	The Enchanted Shield provides the bearer's regiment with an extra level of armour. This item can only be utilised by troops who are normally able to use a shield.	false
character_skills_localised_description_grudge_skill_shield_of_ptolos	The Shield of Ptolos is magically inscribed with a myriad of distracting patterns and designs. The patterns magically distract arrows and bolts, sending them spinning off course. The bearer's regiment will be protected against missiles from bows, crossbows, war engines and so on. Additionally, the shield provides the bearer's regiment with a basic level of armour.	false
character_skills_localised_description_grudge_skill_spelleater_shield	The Spelleater Shield is inscribed with symbols which have the power to absorb enemy magic. Whenever the bearer's regiment is the target of an enemy spell the shield has a good chance of absorbing the magic and channeling its power to any friendly mages. The shield can also negate the effects of enemy magic items. Additionally, the shield provides the bearer's regiment with a basic level of armour.	false
character_skills_localised_description_grudge_skill_dragonhelm	This magic helmet protects the bearer's regiment from the effects of fire or flame attacks. The magical powers are so effective that almost all such attacks will be ineffective.	false
character_skills_localised_description_grudge_skill_wand_of_jet	This powerful wand channels the energy of the winds of magic, providing the bearer with extra magical powers. Any spell in the bearer's repertoire can be cast for less magic points than it would normally cost, to a minimum of one point.	false
character_skills_localised_description_grudge_skill_banner_of_arcane_warding	The banner of Arcane Warding is inscribed with sigils to twist magic aside and deflect it in unpredictable paths. When a hostile spell is cast against a regiment bearing this banner the spell is likely to be either negated or deflected towards the closest enemy regiment.	false
character_skills_localised_description_grudge_skill_banner_of_wrath	This hallowed banner has been infused with power and can lash the enemy with bolts of pure energy. It may be cast, unleashing up to six mighty lightning bolts upon enemy troops within range	false
character_skills_localised_description_grudge_skill_banner_of_defiance	This powerful banner infuses the bearer's regiment with extra courage, making them braver and more determined. A regiment bearing this banner will never break from hand-to-hand combat and is immune to fear.	false
character_skills_localised_name_grudge_skill_shadow_of_the_horned_rat	Shadow of the Horned Rat	false
character_skills_localised_name_grudge_skill_dark_omen	Dark Omen	false
character_skills_localised_description_grudge_skill_shadow_of_the_horned_rat	These warriors are veterans of the "Shadow of the Horned Rat" campaign. They learned hard how to stop Vermintide and Waagh.	false
character_skills_localised_description_grudge_skill_dark_omen	These warriors are veterans of the "Dark Omen" campaign. They know pretty well, that the dead should not disturb the living.	false
character_skills_localised_name_obo_skill_ability_extra_powder	Extra Powder	false
character_skills_localised_name_obo_skill_ability_more_powder	More Powder!	false
character_skills_localised_description_obo_skill_ability_extra_powder	Because you can never have too much.	false
character_skills_localised_description_obo_skill_ability_more_powder	"Where's that powder monkey? Get him up 'ere now!"	false
character_skills_localised_name_ovn_grudge_soldiers_of_fortune	The Bonds of War	false
character_skills_localised_description_ovn_grudge_soldiers_of_fortune	Many regiments have come and gone but those few that bear the Grudgebringer name have developed a brotherhood like no other.	false
character_skills_localised_name_ovn_grudge_gold	For Gold	false
character_skills_localised_description_ovn_grudge_gold	If death is a reward, I'll take it in gold coin, old friend. The glory we'll leave for others.	false
character_skills_localised_name_ovn_grudge_glory	Greater than Glory	false
character_skills_localised_description_ovn_grudge_glory	I don't give a damn about glory, I do what I must.	false
