Loc PackedFile	1
key	text	tooltip
building_culture_variants_name_ovn_arb_hosp_1wh_main_sc_emp_araby	Field Hospital	true
building_chains_chain_tooltip_ovn_arb_hosp	Healing	true
building_short_description_texts_short_description_ovn_arb_hosp	The Arabyans value life and endeavour in the noble pursuit of healing and easing suffering.	true
building_culture_variants_name_ovn_arb_hosp_2wh_main_sc_emp_araby	University Hospital	true
building_chains_chain_tooltip_ovn_cd_slave	Slaves	true
building_chains_chain_tooltip_ovn_cd_work	Workshop	true
building_culture_variants_name_ovn_arb_haikkwh_main_sc_emp_araby	Palace of the Great Sultan	true
building_culture_variants_name_ovn_arb_belwh_main_sc_emp_araby	Gardens of Bel-Aliad	true
building_culture_variants_name_ovn_arb_fyruswh_main_sc_emp_araby	Great Tomb of Mullah Aklanâ€™d	true
building_culture_variants_name_ovn_arb_Sabarwh_main_sc_emp_araby	Ivory Palace of Ka-Sabar	true
building_culture_variants_name_ovn_arb_Madrasatwh_main_sc_emp_araby	Madrasat el-Se'hr	true
building_culture_variants_name_ovn_arb_Sartosawh_main_sc_emp_araby	Fortress of Nafel Muq	true
building_culture_variants_name_ovn_arb_Magrittawh_main_sc_emp_araby	The Black-Gold Tower	true
building_culture_variants_name_ovn_arb_Twilightwh_main_sc_emp_araby	Portal of Twilight	true
building_culture_variants_name_ovn_arb_Cryptwh_main_sc_emp_araby	Crypt of Abdul ben Rachid	true
building_culture_variants_name_ovn_Citadel_of_dusk	Morvael's Sunset Citadel	true
building_chains_chain_tooltip_ovn_Citadel_of_dusk	Citadel of Dusk Landmark	true
building_short_description_texts_short_description_ovn_Citadel_of_dusk	The garrison-port was established long ago under the orders of the then Phoenix King Morvael. The looming towers still serve as a reminder of the Asur's colonial might.	true
building_chains_chain_tooltip_ovn_Clan_Fester	Skaven	false
building_short_description_texts_short_description_Clan_Fester_1	As part of the Pactsworn, the Skaven and Rotbloods combine their forces to bring ruin to their enemies.	false
building_short_description_texts_short_description_Clan_Fester_2	As the Skaven are allowed to burrow deeper and wider they bring with them the rank and file.	false
building_short_description_texts_short_description_Clan_Fester_3	As the Pactsworn bears its rotten fruits the Rottblood can now bring to bear the fiercest of Skaven. 	false
building_chains_chain_tooltip_alb_resource_wood	resource	false
building_culture_variants_name_alb_resource_wood_1wh2_main_nor_albion	Woodmen Hut	false
building_culture_variants_name_alb_resource_wood_2wh2_main_nor_albion	Small Lumber Camp	false
building_culture_variants_name_alb_resource_wood_3wh2_main_nor_albion	Lumber Camp	false
building_chains_chain_tooltip_alb_resource_medicine	resource	false
building_culture_variants_name_alb_resource_medicine_1wh2_main_nor_albion	Medicine Hut	false
building_culture_variants_name_alb_resource_medicine_2wh2_main_nor_albion	Apothecary	false
building_culture_variants_name_alb_resource_medicine_3wh2_main_nor_albion	Great Apothecary	false
building_chains_chain_tooltip_alb_resource_pottery	resource	false
building_culture_variants_name_alb_resource_pottery_1wh2_main_nor_albion	Clay Pit	false
building_culture_variants_name_alb_resource_pottery_2wh2_main_nor_albion	Pottery Workshop	false
building_culture_variants_name_alb_resource_pottery_3wh2_main_nor_albion	Master Pottery Workshop	false
building_chains_chain_tooltip_alb_resource_gold	resource	false
building_culture_variants_name_alb_resource_goldwh2_main_nor_albion	Open Gold Pit	false
building_chains_chain_tooltip_alb_resource_iron	resource	false
building_culture_variants_name_alb_resource_ironwh2_main_nor_albion	Open Iron Pit	false
building_chains_chain_tooltip_alb_resource_marble	resource	false
building_culture_variants_name_alb_resource_marblewh2_main_nor_albion	Open Marble Pit	false
building_short_description_texts_short_description_ovn_albion_wood	Like most races, those from Albion are no stranger to felling trees to use in construction.	true
building_short_description_texts_short_description_ovn_albion_wood2	Most Albion architecture is based around mud buildings with thatched roofing with wood reserved for their more grandiose buildings.	true
building_short_description_texts_short_description_ovn_albion_wood3	With a glut of wood available, common log cabins can be seen sprouting up amongst the common folk.	true
building_short_description_texts_short_description_ovn_albion_gold	Albion lacks the technology to properly mine, so with crude pickaxes they work on above-ground seams of gold.	true
building_short_description_texts_short_description_ovn_albion_iron	Albion lacks the technology to properly mine, so with crude pickaxes they work on above-ground seams of gold.	true
building_short_description_texts_short_description_ovn_albion_marble	Albion lacks the technology to properly mine, so with crude pickaxes they work on above-ground seams of gold.	true
building_short_description_texts_short_description_ovn_albion_medicine	The wise elderly women of Albion, who know the old ways forage for herbs which will cure all manner of ills.	true
building_culture_variants_name_wh2_dlc15_special_settlement_massif_orcal_norsca_1wh2_main_nor_albion	Occupied Massif Orcal (Warrior Gathering)	false
building_culture_variants_name_wh2_dlc15_special_settlement_massif_orcal_norsca_2wh2_main_nor_albion	Occupied Massif Orcal (Warband Camp)	false
building_culture_variants_name_wh2_dlc15_special_settlement_massif_orcal_norsca_3wh2_main_nor_albion	Occupied Massif Orcal (Clan Enclave)	false
building_culture_variants_name_wh2_dlc15_special_settlement_massif_orcal_norsca_4wh2_main_nor_albion	Occupied Massif Orcal (Tribal Stronghold)	false
building_culture_variants_name_wh2_dlc15_special_settlement_massif_orcal_norsca_5wh2_main_nor_albion	Occupied Massif Orcal (Greater Tribal Stronghold)	false
building_short_description_texts_short_description_ovn_alb_port1	No one can afford to ignore a plentiful, cheap source of food from the waters nearby.	false
building_short_description_texts_short_description_ovn_alb_port2	A deep-sea fishing fleet can bring in a larger catch than inshore boats. Most of the catch has to be salted or pickled for return to port. 	false
building_short_description_texts_short_description_ovn_alb_port3	A major fishery is a complex network of workshops and small industries, all providing the support needed for large scale fishing.	false
building_short_description_texts_short_description_ovn_alb_inc1	Truthsaysers are masters of honing out trinkets of interest.	false
building_short_description_texts_short_description_ovn_alb_inc2	Artifacts lost to time need special care to bring them back to their former power and splendor.	false
building_short_description_texts_short_description_ovn_alb_inc3	The Ogham Stones hold immense power and by extension the druids that protect and maintain them.	false
building_culture_variants_name_wh_main_nor_slaves_1wh2_main_nor_albion	Trinket Collector	false
building_culture_variants_name_wh_main_nor_slaves_2wh2_main_nor_albion	Artifact Restorer	false
building_culture_variants_name_wh_main_nor_slaves_3wh2_main_nor_albion	Ogham Stone Keeper	false
building_culture_variants_name_wh_main_nor_portwh2_main_nor_albion	Albion Fishing Village	false
building_culture_variants_name_wh_main_nor_port_2wh2_main_nor_albion	Middle Sea Fishery	false
building_culture_variants_name_wh_main_nor_port_3wh2_main_nor_albion	Great Ocean Fishery	false
building_culture_variants_name_wh2_main_foreign_slot_discovery_nor_1wh2_main_nor_albion	Night Patrols	false
building_culture_variants_name_wh2_main_lzd_saurus_2wh2_main_lzd_lizardmenwh2_main_sc_lzd_lizardmenwh2_main_amz_amazons	Amazonian War-Temple	false
building_culture_variants_name_wh2_main_lzd_saurus_1wh2_main_lzd_lizardmenwh2_main_sc_lzd_lizardmenwh2_main_amz_amazons	Amazonian War-Pit	false
building_culture_variants_name_wh2_main_lzd_farm_2wh2_main_lzd_lizardmenwh2_main_sc_lzd_lizardmenwh2_main_amz_amazons	Amazonian Hunting Grounds	false
building_culture_variants_name_wh2_main_lzd_farm_1wh2_main_lzd_lizardmenwh2_main_sc_lzd_lizardmenwh2_main_amz_amazons	Amazonian Foraging Camp	false
building_culture_variants_name_wh2_main_lzd_industry_1wh2_main_lzd_lizardmenwh2_main_sc_lzd_lizardmenwh2_main_amz_amazons	Amazonian Dungeon	false
building_culture_variants_name_wh2_main_lzd_industry_2wh2_main_lzd_lizardmenwh2_main_sc_lzd_lizardmenwh2_main_amz_amazons	Amazonian Trophy Hall	false
building_culture_variants_name_wh2_main_lzd_industry_3wh2_main_lzd_lizardmenwh2_main_sc_lzd_lizardmenwh2_main_amz_amazons	Amazonian Artefact Hold	false
building_culture_variants_name_ovn_arb_forge_1wh_main_sc_emp_araby	Ballista Workshop	false
building_culture_variants_name_ovn_arb_forge_2wh_main_sc_emp_araby	Carpenters Atelier	false
building_culture_variants_name_ovn_arb_forge_3wh_main_sc_emp_araby	Black Powder Forges	false
building_culture_variants_name_ovn_arb_nomad_1wh_main_sc_emp_araby	Caravan Stop	false
building_culture_variants_name_ovn_arb_nomad_2wh_main_sc_emp_araby	Nomad Trading Post	false
building_culture_variants_name_ovn_arb_nomad_3wh_main_sc_emp_araby	Tribal Assembly	false
building_culture_variants_name_ovn_arb_nomad_4wh_main_sc_emp_araby	Giant Camp	false
building_culture_variants_name_ovn_arb_xpwh_main_sc_emp_araby	Kasbah 	false
building_culture_variants_name_ovn_arb_scy_tmbwh2_main_arb_aswad_scythans	Tomb King Crypt	true
building_culture_variants_name_ovn_blood_keep	Blood Keep Jousting Arena	true
building_culture_variants_name_ovn_blood_landmark	Blood Keep Sparring Ground	true
building_chains_chain_tooltip_ovn_blood_landmark	Vampire Landmark	true
building_short_description_texts_short_description_ovn_blood_landmark	Here knights are drilled with a blend of traditional swordsmanship and unusual techniques birthed in Lahmia dating back to the ancient days of the Harkoni tribe.	true
building_culture_variants_name_wh2_main_special_settlement_castle_drakenhof_norsca_1wh_main_chs_chaoswh_main_sc_nor_warp	Occupied Drakenhof (Hamlet)	true
building_culture_variants_name_wh2_main_special_settlement_castle_drakenhof_norsca_2wh_main_chs_chaoswh_main_sc_nor_warp	Occupied Drakenhof (Village)	true
building_culture_variants_name_wh2_main_special_settlement_castle_drakenhof_norsca_3wh_main_chs_chaoswh_main_sc_nor_warp	Occupied Drakenhof (Town)	true
building_culture_variants_name_wh2_main_special_settlement_castle_drakenhof_norsca_4wh_main_chs_chaoswh_main_sc_nor_warp	Occupied Drakenhof (City)	true
building_culture_variants_name_wh2_main_special_settlement_castle_drakenhof_norsca_5wh_main_chs_chaoswh_main_sc_nor_warp	Occupied Drakenhof (City-State)	true
building_culture_variants_name_wh_dlc08_nor_resource_obsidian_1wh_main_chs_chaoswh_main_sc_nor_warp	Obsidian Quarry	true
building_culture_variants_name_wh2_main_special_settlement_couronne_norsca_1wh_main_chs_chaoswh_main_sc_nor_warp	Occupied Couronne (Hamlet)	true
building_culture_variants_name_wh2_main_special_settlement_couronne_norsca_2wh_main_chs_chaoswh_main_sc_nor_warp	Occupied Couronne (Village)	true
building_culture_variants_name_wh2_main_special_settlement_couronne_norsca_3wh_main_chs_chaoswh_main_sc_nor_warp	Occupied Couronne (Town)	true
building_culture_variants_name_wh2_main_special_settlement_couronne_norsca_4wh_main_chs_chaoswh_main_sc_nor_warp	Occupied Couronne (City)	true
building_culture_variants_name_wh2_main_special_settlement_couronne_norsca_5wh_main_chs_chaoswh_main_sc_nor_warp	Occupied Couronne (City-State)	true
building_culture_variants_name_wh2_main_special_settlement_the_awakening_norsca_1wh_main_chs_chaoswh_main_sc_nor_warp	Occupied The Awakening Level 1	true
building_culture_variants_name_wh2_main_special_settlement_the_awakening_norsca_2wh_main_chs_chaoswh_main_sc_nor_warp	Occupied The Awakening Level 2	true
building_culture_variants_name_wh2_main_special_settlement_the_awakening_norsca_3wh_main_chs_chaoswh_main_sc_nor_warp	Occupied The Awakening Level 3	true
building_culture_variants_name_wh2_main_special_settlement_the_awakening_norsca_4wh_main_chs_chaoswh_main_sc_nor_warp	Occupied The Awakening Level 4	true
building_culture_variants_name_wh2_main_special_settlement_the_awakening_norsca_5wh_main_chs_chaoswh_main_sc_nor_warp	Occupied The Awakening Level 5	true
building_culture_variants_name_wh_main_special_settlement_karaz_a_karak_5_norscawh_main_chs_chaoswh_main_sc_nor_warp	Occupied Karaz-a-Karak (Great Hold)	true
building_culture_variants_name_wh_main_special_settlement_karaz_a_karak_4_norscawh_main_chs_chaoswh_main_sc_nor_warp	Occupied Karaz-a-Karak (Dwarfhold)	true
building_culture_variants_name_wh_main_special_settlement_karaz_a_karak_3_norscawh_main_chs_chaoswh_main_sc_nor_warp	Occupied Karaz-a-Karak (Dwarf Keep)	true
building_culture_variants_name_wh_main_special_settlement_karaz_a_karak_2_norscawh_main_chs_chaoswh_main_sc_nor_warp	Occupied Karaz-a-Karak (Outpost)	true
building_culture_variants_name_wh_main_special_settlement_karaz_a_karak_1_norscawh_main_chs_chaoswh_main_sc_nor_warp	Occupied Karaz-a-Karak (Mining Settlement)	true
building_culture_variants_name_wh2_main_special_settlement_gaean_vale_norsca_1wh_main_chs_chaoswh_main_sc_nor_warp	Occupied Gaean Vale (Warrior Gathering)	true
building_culture_variants_name_wh2_main_special_settlement_gaean_vale_norsca_2wh_main_chs_chaoswh_main_sc_nor_warp	Occupied Gaean Vale (Warband Camp)	true
building_culture_variants_name_wh2_main_special_settlement_gaean_vale_norsca_3wh_main_chs_chaoswh_main_sc_nor_warp	Occupied Gaean Vale (Cult Enclave)	true
building_culture_variants_name_wh2_main_special_settlement_gaean_vale_norsca_4wh_main_chs_chaoswh_main_sc_nor_warp	Occupied Gaean Vale (Chaos Stronghold)	true
building_culture_variants_name_wh2_main_special_settlement_gaean_vale_norsca_5wh_main_chs_chaoswh_main_sc_nor_warp	Occupied Gaean Vale (Greater Chaos Stronghold)	true
building_culture_variants_name_wh2_main_special_settlement_miragliano_norsca_1wh_main_chs_chaoswh_main_sc_nor_warp	Occupied Miragliano (Hamlet)	true
building_culture_variants_name_wh2_main_special_settlement_miragliano_norsca_2wh_main_chs_chaoswh_main_sc_nor_warp	Occupied Miragliano (Village)	true
building_culture_variants_name_wh2_main_special_settlement_miragliano_norsca_3wh_main_chs_chaoswh_main_sc_nor_warp	Occupied Miragliano (Town)	true
building_culture_variants_name_wh2_main_special_settlement_miragliano_norsca_4wh_main_chs_chaoswh_main_sc_nor_warp	Occupied Miragliano (City)	true
building_culture_variants_name_wh2_main_special_settlement_miragliano_norsca_5wh_main_chs_chaoswh_main_sc_nor_warp	Occupied Miragliano (City-State)	true
building_culture_variants_name_wh2_main_foreign_slot_discovery_nor_1wh_main_chs_chaoswh_main_sc_nor_warp	Marauder Patrols	true
building_culture_variants_name_wh_main_nor_erengrad_uniquewh_main_chs_chaoswh_main_sc_nor_warp	Cave of the Rocky Throne	true
building_culture_variants_name_wh2_main_special_settlement_kislev_norsca_1wh_main_chs_chaoswh_main_sc_nor_warp	Occupied Kislev (Hamlet)	true
building_culture_variants_name_wh2_main_special_settlement_kislev_norsca_2wh_main_chs_chaoswh_main_sc_nor_warp	Occupied Kislev (Village)	true
building_culture_variants_name_wh2_main_special_settlement_kislev_norsca_3wh_main_chs_chaoswh_main_sc_nor_warp	Occupied Kislev (Town)	true
building_culture_variants_name_wh2_main_special_settlement_kislev_norsca_4wh_main_chs_chaoswh_main_sc_nor_warp	Occupied Kislev (City)	true
building_culture_variants_name_wh2_main_special_settlement_kislev_norsca_5wh_main_chs_chaoswh_main_sc_nor_warp	Occupied Kislev (City-State)	true
building_culture_variants_name_wh2_main_special_settlement_lahmia_norsca_1wh_main_chs_chaoswh_main_sc_nor_warp	Occupied Lahmia (Warrior Gathering)	true
building_culture_variants_name_wh2_main_special_settlement_lahmia_norsca_2wh_main_chs_chaoswh_main_sc_nor_warp	Occupied Lahmia (Warband Camp)	true
building_culture_variants_name_wh2_main_special_settlement_lahmia_norsca_3wh_main_chs_chaoswh_main_sc_nor_warp	Occupied Lahmia (Cult Enclave)	true
building_culture_variants_name_wh2_main_special_settlement_lahmia_norsca_4wh_main_chs_chaoswh_main_sc_nor_warp	Occupied Lahmia (Chaos Stronghold)	true
building_culture_variants_name_wh2_main_special_settlement_lahmia_norsca_5wh_main_chs_chaoswh_main_sc_nor_warp	Occupied Lahmia (Greater Chaos Stronghold)	true
building_culture_variants_name_wh2_main_special_settlement_khemri_norsca_1wh_main_chs_chaoswh_main_sc_nor_warp	Occupied Khemri (Warrior Gathering)	true
building_culture_variants_name_wh2_main_special_settlement_khemri_norsca_2wh_main_chs_chaoswh_main_sc_nor_warp	Occupied Khemri (Warband Camp)	true
building_culture_variants_name_wh2_main_special_settlement_khemri_norsca_3wh_main_chs_chaoswh_main_sc_nor_warp	Occupied Khemri (Cult Enclave)	true
building_culture_variants_name_wh2_main_special_settlement_khemri_norsca_4wh_main_chs_chaoswh_main_sc_nor_warp	Occupied Khemri (Chaos Stronghold)	true
building_culture_variants_name_wh2_main_special_settlement_khemri_norsca_5wh_main_chs_chaoswh_main_sc_nor_warp	Occupied Khemri (Greater Chaos Stronghold)	true
building_culture_variants_name_wh_dlc08_nor_resource_marble_1wh_main_chs_chaoswh_main_sc_nor_warp	Marble Quarry	true
building_culture_variants_name_wh_dlc08_special_bordeleaux_port_norsca_1wh_main_chs_chaoswh_main_sc_nor_warp	Bordeleaux Port	true
building_culture_variants_name_wh_dlc08_special_erengrad_port_norsca_1wh_main_chs_chaoswh_main_sc_nor_warp	Erengrad Docks	true
building_culture_variants_name_wh_dlc08_special_marienburg_port_norsca_1wh_main_chs_chaoswh_main_sc_nor_warp	Marienburg Docks	true
building_culture_variants_name_wh_main_special_settlement_black_crag_5_norscawh_main_chs_chaoswh_main_sc_nor_warp	Occupied Black Crag/Karak Drazh (Great Hold)	true
building_culture_variants_name_wh_main_special_settlement_black_crag_4_norscawh_main_chs_chaoswh_main_sc_nor_warp	Occupied Black Crag/Karak Drazh (Dwarfhold)	true
building_culture_variants_name_wh2_main_special_settlement_altdorf_norsca_1wh_main_chs_chaoswh_main_sc_nor_warp	Occupied Altdorf (Hamlet)	true
building_culture_variants_name_wh2_main_special_settlement_altdorf_norsca_2wh_main_chs_chaoswh_main_sc_nor_warp	Occupied Altdorf (Village)	true
building_culture_variants_name_wh2_main_special_settlement_altdorf_norsca_3wh_main_chs_chaoswh_main_sc_nor_warp	Occupied Altdorf (Town)	true
building_culture_variants_name_wh2_main_special_settlement_altdorf_norsca_4wh_main_chs_chaoswh_main_sc_nor_warp	Occupied Altdorf (City)	true
building_culture_variants_name_wh2_main_special_settlement_altdorf_norsca_5wh_main_chs_chaoswh_main_sc_nor_warp	Occupied Altdorf (City-State)	true
building_culture_variants_name_wh_main_special_settlement_black_crag_3_norscawh_main_chs_chaoswh_main_sc_nor_warp	Occupied Black Crag/Karak Drazh (Dwarf Keep)	true
building_culture_variants_name_wh2_main_special_settlement_hexoatl_norsca_1wh_main_chs_chaoswh_main_sc_nor_warp	Occupied Hexoatl (Warrior Gathering)	true
building_culture_variants_name_wh2_main_special_settlement_hexoatl_norsca_2wh_main_chs_chaoswh_main_sc_nor_warp	Occupied Hexoatl (Warband Camp)	true
building_culture_variants_name_wh2_main_special_settlement_hexoatl_norsca_3wh_main_chs_chaoswh_main_sc_nor_warp	Occupied Hexoatl (Cult Enclave)	true
building_culture_variants_name_wh2_main_special_settlement_hexoatl_norsca_4wh_main_chs_chaoswh_main_sc_nor_warp	Occupied Hexoatl (Chaosl Stronghold)	true
building_culture_variants_name_wh2_main_special_settlement_hexoatl_norsca_5wh_main_chs_chaoswh_main_sc_nor_warp	Occupied Hexoatl (Greater Chaos Stronghold)	true
building_culture_variants_name_wh2_main_special_settlement_lothern_norsca_1wh_main_chs_chaoswh_main_sc_nor_warp	Occupied Lothern (Warrior Gathering)	true
building_culture_variants_name_wh2_main_special_settlement_lothern_norsca_2wh_main_chs_chaoswh_main_sc_nor_warp	Occupied Lothern (Warband Camp)	true
building_culture_variants_name_wh2_main_special_settlement_lothern_norsca_3wh_main_chs_chaoswh_main_sc_nor_warp	Occupied Lothern (Cult Enclave)	true
building_culture_variants_name_wh2_main_special_settlement_lothern_norsca_4wh_main_chs_chaoswh_main_sc_nor_warp	Occupied Lothern (Chaos Stronghold)	true
building_culture_variants_name_wh2_main_special_settlement_lothern_norsca_5wh_main_chs_chaoswh_main_sc_nor_warp	Occupied Lothern (Greater Chaos Stronghold)	true
building_culture_variants_name_wh_main_special_settlement_black_crag_2_norscawh_main_chs_chaoswh_main_sc_nor_warp	Occupied Black Crag/Karak Drazh (Outpost)	true
building_culture_variants_name_wh2_main_special_settlement_skavenblight_norsca_1wh_main_chs_chaoswh_main_sc_nor_warp	Occupied Skavenblight (Warrior Gathering)	true
building_culture_variants_name_wh2_main_special_settlement_skavenblight_norsca_2wh_main_chs_chaoswh_main_sc_nor_warp	Occupied Skavenblight (Warband Camp)	true
building_culture_variants_name_wh2_main_special_settlement_skavenblight_norsca_3wh_main_chs_chaoswh_main_sc_nor_warp	Occupied Skavenblight (Cult Enclave)	true
building_culture_variants_name_wh2_main_special_settlement_skavenblight_norsca_4wh_main_chs_chaoswh_main_sc_nor_warp	Occupied Skavenblight (Chaos Stronghold)	true
building_culture_variants_name_wh2_main_special_settlement_skavenblight_norsca_5wh_main_chs_chaoswh_main_sc_nor_warp	Occupied Skavenblight (Greater Chaos Stronghold)	true
building_culture_variants_name_wh_main_special_settlement_black_crag_1_norscawh_main_chs_chaoswh_main_sc_nor_warp	Occupied Black Crag/Karak Drazh (Mining Settlement)	true
building_culture_variants_name_wh_main_special_settlement_eight_peaks_4_norscawh_main_chs_chaoswh_main_sc_nor_warp	Occupied Karak Eight Peaks (Dwarfhold)	true
building_culture_variants_name_wh_main_special_settlement_eight_peaks_5_norscawh_main_chs_chaoswh_main_sc_nor_warp	Occupied Karak Eight Peaks (Great Hold)	true
building_culture_variants_name_wh_main_special_settlement_eight_peaks_2_norscawh_main_chs_chaoswh_main_sc_nor_warp	Occupied Karak Eight Peaks (Outpost)	true
building_culture_variants_name_wh_main_special_settlement_eight_peaks_3_norscawh_main_chs_chaoswh_main_sc_nor_warp	Occupied Karak Eight Peaks (Dwarf Keep)	true
building_culture_variants_name_wh_main_special_settlement_eight_peaks_1_norscawh_main_chs_chaoswh_main_sc_nor_warp	Occupied Karak Eight Peaks (Mining Settlement)	true
building_culture_variants_name_wh2_main_special_lothern_port_norsca_1wh_main_chs_chaoswh_main_sc_nor_warp	Lothern Port	true
building_culture_variants_name_wh2_main_special_settlement_naggarond_norsca_1wh_main_chs_chaoswh_main_sc_nor_warp	Occupied Naggarond (Warrior Gathering)	true
building_culture_variants_name_wh2_main_special_settlement_naggarond_norsca_2wh_main_chs_chaoswh_main_sc_nor_warp	Occupied Naggarond (Warband Camp)	true
building_culture_variants_name_wh2_main_special_settlement_naggarond_norsca_3wh_main_chs_chaoswh_main_sc_nor_warp	Occupied Naggarond (Cult Enclave)	true
building_culture_variants_name_wh2_main_special_settlement_naggarond_norsca_4wh_main_chs_chaoswh_main_sc_nor_warp	Occupied Naggarond (Chaos Stronghold)	true
building_culture_variants_name_wh2_main_special_settlement_naggarond_norsca_5wh_main_chs_chaoswh_main_sc_nor_warp	Occupied Naggarond (Greater Chaos Stronghold)	true
building_culture_variants_name_wh2_main_special_settlement_sartosa_norsca_1wh_main_chs_chaoswh_main_sc_nor_warp	Occupied Sartosa Level 1	true
building_culture_variants_name_wh2_main_special_settlement_sartosa_norsca_2wh_main_chs_chaoswh_main_sc_nor_warp	Occupied Sartosa Level 2	true
building_culture_variants_name_wh2_main_special_settlement_sartosa_norsca_3wh_main_chs_chaoswh_main_sc_nor_warp	Occupied Sartosa Level 3	true
building_culture_variants_name_wh2_main_special_settlement_sartosa_norsca_4wh_main_chs_chaoswh_main_sc_nor_warp	Occupied Sartosa Level 4	true
building_culture_variants_name_wh2_main_special_settlement_sartosa_norsca_5wh_main_chs_chaoswh_main_sc_nor_warp	Occupied Sartosa Level 5	true
building_culture_variants_name_wh2_main_special_settlement_itza_norsca_1wh_main_chs_chaoswh_main_sc_nor_warp	Occupied Itza (Warrior Gathering)	true
building_culture_variants_name_wh2_main_special_settlement_itza_norsca_2wh_main_chs_chaoswh_main_sc_nor_warp	Occupied Itza (Warband Camp)	true
building_culture_variants_name_wh2_main_special_settlement_itza_norsca_3wh_main_chs_chaoswh_main_sc_nor_warp	Occupied Itza (Cult Enclave)	true
building_culture_variants_name_wh2_main_special_settlement_itza_norsca_4wh_main_chs_chaoswh_main_sc_nor_warp	Occupied Itza (Chaos Stronghold)	true
building_culture_variants_name_wh2_main_special_settlement_itza_norsca_5wh_main_chs_chaoswh_main_sc_nor_warp	Occupied Itza (Greater Chaos Stronghold)	true
building_culture_variants_name_wh2_main_special_settlement_hellpit_norsca_1wh_main_chs_chaoswh_main_sc_nor_warp	Occupied Hellpit (Warrior Gathering)	true
building_culture_variants_name_wh2_main_special_settlement_hellpit_norsca_2wh_main_chs_chaoswh_main_sc_nor_warp	Occupied Hellpit (Warband Camp)	true
building_culture_variants_name_wh2_main_special_settlement_hellpit_norsca_3wh_main_chs_chaoswh_main_sc_nor_warp	Occupied Hellpit (Cult Enclave)	true
building_culture_variants_name_wh2_main_special_settlement_hellpit_norsca_4wh_main_chs_chaoswh_main_sc_nor_warp	Occupied Hellpit (Chaos Stronghold)	true
building_culture_variants_name_wh2_main_special_settlement_hellpit_norsca_5wh_main_chs_chaoswh_main_sc_nor_warp	Occupied Hellpit (Greater Chaos Stronghold)	true
building_culture_variants_name_wh_dlc08_nor_resource_iron_1wh_main_chs_chaoswh_main_sc_nor_warp	Iron Mine	true
building_culture_variants_name_wh2_dlc15_special_settlement_massif_orcal_norsca_1wh_main_sc_nor_warp	Occupied Massif Orcal (Warrior Gathering)	false
building_culture_variants_name_wh2_dlc15_special_settlement_massif_orcal_norsca_2wh_main_sc_nor_warp	Occupied Massif Orcal (Warband Camp)	false
building_culture_variants_name_wh2_dlc15_special_settlement_massif_orcal_norsca_3wh_main_sc_nor_warp	Occupied Massif Orcal (Cult Enclave)	false
building_culture_variants_name_wh2_dlc15_special_settlement_massif_orcal_norsca_4wh_main_sc_nor_warp	Occupied Massif Orcal (Chaos Stronghold)	false
building_culture_variants_name_wh2_dlc15_special_settlement_massif_orcal_norsca_5wh_main_sc_nor_warp	Occupied Massif Orcal (Greater Chaos Stronghold)	false
building_culture_variants_name_wh2_main_special_settlement_konquata_norsca_4wh_main_sc_nor_warp	Occupied Konquata (Chaos Stronghold)	true
building_culture_variants_name_wh2_main_special_settlement_konquata_norsca_5wh_main_sc_nor_warp	Occupied Konquata (Greater Chaos Stronghold)	true
building_culture_variants_name_wh_twa03_special_albion_port_norsca_1wh_main_sc_nor_warp	Albion Docks	true
building_culture_variants_name_wh2_main_special_settlement_konquata_norsca_3wh_main_sc_nor_warp	Occupied Konquata (Cult Enclave)	true
building_culture_variants_name_wh2_main_special_settlement_konquata_norsca_1wh_main_sc_nor_warp	Occupied Konquata (Warrior Gathering)	true
building_culture_variants_name_wh2_main_special_settlement_konquata_norsca_2wh_main_sc_nor_warp	Occupied Konquata (Warband Camp)	true
building_culture_variants_name_albion_hall_heroeswh2_main_nor_albion	Hall of Heroes	true
building_culture_variants_name_albion_hunters_1wh2_main_nor_albion	Hunter Cottage	true
building_culture_variants_name_albion_hunters_2wh2_main_nor_albion	Hunter Longhouse	true
building_culture_variants_name_albion_hunters_3wh2_main_nor_albion	Hall of Trophies	true
building_culture_variants_name_albion_order_1wh2_main_nor_albion	Tribal Meeting	true
building_culture_variants_name_albion_order_2wh2_main_nor_albion	Tribal Gathering	true
building_culture_variants_name_albion_order_3wh2_main_nor_albion	Tribal Council	true
building_culture_variants_name_albion_smith_1wh2_main_nor_albion	Blacksmith	true
building_culture_variants_name_albion_smith_2wh2_main_nor_albion	Artist Blacksmith	true
building_culture_variants_name_elo_ogham_stone_1wh2_main_nor_albion	Ogham Stone	true
building_culture_variants_name_elo_ogham_stone_2wh2_main_nor_albion	Ogham Stone Circle	true
building_culture_variants_name_elo_ogham_stone_4wh2_main_nor_albion	Greater Ogham Stone Circle	true
building_culture_variants_name_elo_ogham_stone_3wh2_main_nor_albion	Grand Ogham Stone Circle	true
building_culture_variants_name_elo_temple_danu_1wh2_main_nor_albion	Shrine of Danu	true
building_culture_variants_name_elo_temple_danu_2wh2_main_nor_albion	Temple of Danu	true
building_culture_variants_name_elo_temple_danu_3wh2_main_nor_albion	Greater Temple of Danu	true
building_culture_variants_name_ovn_albion_military_1wh2_main_nor_albion	Sparring Field	true
building_culture_variants_name_ovn_albion_military_2wh2_main_nor_albion	Warriors' Hall	true
building_culture_variants_name_ovn_albion_military_3wh2_main_nor_albion	Chieftain's Hall	true
building_culture_variants_name_wh_main_nor_outpost_garrison_1wh2_main_nor_albion	Watchtower	true
building_culture_variants_name_wh_main_nor_outpost_garrison_2wh2_main_nor_albion	Guard Patrols	true
building_culture_variants_name_wh_main_nor_outpost_garrison_3wh2_main_nor_albion	Fortified Palisades	true
building_culture_variants_name_wh_main_nor_outpost_major_human_1_coastwh2_main_nor_albion	Settled Tribe	true
building_culture_variants_name_wh_main_nor_outpost_major_human_1wh2_main_nor_albion	Settled Tribe	true
building_culture_variants_name_wh_main_nor_outpost_major_human_2_coastwh2_main_nor_albion	Tribal Settlement	true
building_culture_variants_name_wh_main_nor_outpost_major_human_2wh2_main_nor_albion	Tribal Settlement	true
building_culture_variants_name_wh_main_nor_outpost_major_human_3_coastwh2_main_nor_albion	Tribal Village	true
building_culture_variants_name_wh_main_nor_outpost_major_human_3wh2_main_nor_albion	Tribal Village	true
building_culture_variants_name_ovn_albion_outpost_military_1wh2_main_nor_albion	Sparring Field	true
building_culture_variants_name_ovn_albion_outpost_military_2wh2_main_nor_albion	Warriors' Hall	true
building_culture_variants_name_ovn_albion_outpost_military_3wh2_main_nor_albion	Chieftain's Hall	true
building_culture_variants_name_wh_main_nor_outpost_minor_human_1_coastwh2_main_nor_albion	Settled Tribe	true
building_culture_variants_name_wh_main_nor_outpost_minor_human_1wh2_main_nor_albion	Settled Tribe	true
building_culture_variants_name_wh_main_nor_outpost_minor_human_2_coastwh2_main_nor_albion	Tribal Settlement	true
building_culture_variants_name_wh_main_nor_outpost_minor_human_2wh2_main_nor_albion	Tribal Settlement	true
building_culture_variants_name_wh_main_nor_outpost_minor_human_3_coastwh2_main_nor_albion	Tribal Village	true
building_culture_variants_name_wh_main_nor_outpost_minor_human_3wh2_main_nor_albion	Tribal Village	true
building_culture_variants_name_ovn_albion_outpost_stables_1wh2_main_nor_albion	Shieling	true
building_culture_variants_name_ovn_albion_outpost_stables_2wh2_main_nor_albion	Corral	true
building_culture_variants_name_ovn_albion_outpost_stables_3wh2_main_nor_albion	Albion Stables	true
building_culture_variants_name_wh_main_nor_settlement_major_1_coastwh2_main_nor_albion	Settled Tribe	true
building_culture_variants_name_wh_main_nor_settlement_major_1wh2_main_nor_albion	Settled Tribe	true
building_culture_variants_name_wh_main_nor_settlement_major_2_coastwh2_main_nor_albion	Tribal Settlement	true
building_culture_variants_name_wh_main_nor_settlement_major_2wh2_main_nor_albion	Tribal Settlement	true
building_culture_variants_name_wh_main_nor_settlement_major_3_coastwh2_main_nor_albion	Tribal Village	true
building_culture_variants_name_wh_main_nor_settlement_major_3wh2_main_nor_albion	Tribal Village	true
building_culture_variants_name_wh_main_nor_settlement_major_4_coastwh2_main_nor_albion	Clan City	true
building_culture_variants_name_wh_main_nor_settlement_major_4wh2_main_nor_albion	Clan City	true
building_culture_variants_name_wh_main_nor_settlement_major_5_coastwh2_main_nor_albion	Clan Stronghold	true
building_culture_variants_name_wh_main_nor_settlement_major_5wh2_main_nor_albion	Clan Stronghold	true
building_culture_variants_name_wh_main_nor_settlement_minor_1_coastwh2_main_nor_albion	Settled Tribe	true
building_culture_variants_name_wh_main_nor_settlement_minor_1wh2_main_nor_albion	Settled Tribe	true
building_culture_variants_name_wh_main_nor_settlement_minor_2_coastwh2_main_nor_albion	Tribal Settlement	true
building_culture_variants_name_wh_main_nor_settlement_minor_2wh2_main_nor_albion	Tribal Settlement	true
building_culture_variants_name_wh_main_nor_settlement_minor_3_coastwh2_main_nor_albion	Tribal Village	true
building_culture_variants_name_wh_main_nor_settlement_minor_3wh2_main_nor_albion	Tribal Village	true
building_culture_variants_name_ovn_albion_stables_1wh2_main_nor_albion	Shieling	true
building_culture_variants_name_ovn_albion_stables_2wh2_main_nor_albion	Corral	true
building_culture_variants_name_ovn_albion_stables_3wh2_main_nor_albion	Albion Stables	true
building_culture_variants_name_wh_main_nor_walls_1wh2_main_nor_albion	Wooden Fences	true
building_culture_variants_name_wh_main_nor_walls_2wh2_main_nor_albion	Barricades	true
building_culture_variants_name_wh_main_nor_walls_3wh2_main_nor_albion	Palisades	true
building_culture_variants_name_albion_gryphon_eyriewh2_main_nor_albion	Highlander's Encampment	true
building_culture_variants_name_albion_gryphon_eyrie_0wh2_main_nor_albion	Hill Encampment	true
building_culture_variants_name_albion_oracle_hall_1wh2_main_nor_albion	Maidens' Hall	true
building_culture_variants_name_albion_oracle_hall_2wh2_main_nor_albion	Oracle's Hall	true
building_culture_variants_name_wh2_main_special_settlement_konquata_norsca_4wh_main_sc_nor_albion	Konquata (Settled Tribe)	true
building_culture_variants_name_wh2_main_special_settlement_konquata_norsca_5wh_main_sc_nor_albion	Konquata (Tribal Settlement)	true
building_culture_variants_name_wh_twa03_special_albion_port_norsca_1wh_main_sc_nor_albion	Albion Docks	true
building_culture_variants_name_wh2_main_special_settlement_konquata_norsca_3wh_main_sc_nor_albion	Konquata (Tribal Village)	true
building_culture_variants_name_wh2_main_special_settlement_konquata_norsca_1wh_main_sc_nor_albion	Konquata (Clan City)	true
building_culture_variants_name_wh2_main_special_settlement_konquata_norsca_2wh_main_sc_nor_albion	Konquata (Clan Stronghold)	true
building_culture_variants_name_elo_great_oghamwh2_main_nor_albion	The Great Ogham Circle	true
building_culture_variants_name_elo_forge_old_oneswh2_main_nor_albion	Forge of the Old Ones	true
building_culture_variants_name_elo_citadel_leadwh2_main_nor_albion	Sealed Citadel of Lead	true
building_culture_variants_name_elo_dragon_cragwh2_main_nor_trollz	Dragon Crag	true
building_culture_variants_name_dread_king_burial_3wh2_dlc09_tmb_the_sentinels	Dread Legion Burial Site	true
building_culture_variants_name_dread_king_burial_4wh2_dlc09_tmb_the_sentinels	Dread Legion Tomb	true
building_culture_variants_name_wh2_main_special_settlement_castle_drakenhof_norsca_1wh_main_chs_chaoswh_main_sc_nor_fimir	Occupied Drakenhof (Hamlet)	true
building_culture_variants_name_wh2_main_special_settlement_castle_drakenhof_norsca_2wh_main_chs_chaoswh_main_sc_nor_fimir	Occupied Drakenhof (Village)	true
building_culture_variants_name_wh2_main_special_settlement_castle_drakenhof_norsca_3wh_main_chs_chaoswh_main_sc_nor_fimir	Occupied Drakenhof (Town)	true
building_culture_variants_name_wh2_main_special_settlement_castle_drakenhof_norsca_4wh_main_chs_chaoswh_main_sc_nor_fimir	Occupied Drakenhof (City)	true
building_culture_variants_name_wh2_main_special_settlement_castle_drakenhof_norsca_5wh_main_chs_chaoswh_main_sc_nor_fimir	Occupied Drakenhof (City-State)	true
building_culture_variants_name_wh_dlc08_nor_resource_obsidian_1wh_main_chs_chaoswh_main_sc_nor_fimir	Obsidian Quarry	true
building_culture_variants_name_wh2_main_special_settlement_couronne_norsca_1wh_main_chs_chaoswh_main_sc_nor_fimir	Occupied Couronne (Hamlet)	true
building_culture_variants_name_wh2_main_special_settlement_couronne_norsca_2wh_main_chs_chaoswh_main_sc_nor_fimir	Occupied Couronne (Village)	true
building_culture_variants_name_wh2_main_special_settlement_couronne_norsca_3wh_main_chs_chaoswh_main_sc_nor_fimir	Occupied Couronne (Town)	true
building_culture_variants_name_wh2_main_special_settlement_couronne_norsca_4wh_main_chs_chaoswh_main_sc_nor_fimir	Occupied Couronne (City)	true
building_culture_variants_name_wh2_main_special_settlement_couronne_norsca_5wh_main_chs_chaoswh_main_sc_nor_fimir	Occupied Couronne (City-State)	true
building_culture_variants_name_wh2_main_special_settlement_the_awakening_norsca_1wh_main_chs_chaoswh_main_sc_nor_fimir	Occupied The Awakening Level 1	true
building_culture_variants_name_wh2_main_special_settlement_the_awakening_norsca_2wh_main_chs_chaoswh_main_sc_nor_fimir	Occupied The Awakening Level 2	true
building_culture_variants_name_wh2_main_special_settlement_the_awakening_norsca_3wh_main_chs_chaoswh_main_sc_nor_fimir	Occupied The Awakening Level 3	true
building_culture_variants_name_wh2_main_special_settlement_the_awakening_norsca_4wh_main_chs_chaoswh_main_sc_nor_fimir	Occupied The Awakening Level 4	true
building_culture_variants_name_wh2_main_special_settlement_the_awakening_norsca_5wh_main_chs_chaoswh_main_sc_nor_fimir	Occupied The Awakening Level 5	true
building_culture_variants_name_wh_main_special_settlement_karaz_a_karak_5_norscawh_main_chs_chaoswh_main_sc_nor_fimir	Occupied Karaz-a-Karak (Great Hold)	true
building_culture_variants_name_wh_main_special_settlement_karaz_a_karak_4_norscawh_main_chs_chaoswh_main_sc_nor_fimir	Occupied Karaz-a-Karak (Dwarfhold)	true
building_culture_variants_name_wh_main_special_settlement_karaz_a_karak_3_norscawh_main_chs_chaoswh_main_sc_nor_fimir	Occupied Karaz-a-Karak (Dwarf Keep)	true
building_culture_variants_name_wh_main_special_settlement_karaz_a_karak_2_norscawh_main_chs_chaoswh_main_sc_nor_fimir	Occupied Karaz-a-Karak (Outpost)	true
building_culture_variants_name_wh_main_special_settlement_karaz_a_karak_1_norscawh_main_chs_chaoswh_main_sc_nor_fimir	Occupied Karaz-a-Karak (Mining Settlement)	true
building_culture_variants_name_wh2_main_special_settlement_gaean_vale_norsca_1wh_main_chs_chaoswh_main_sc_nor_fimir	Occupied Gaean Vale (Warrior Gathering)	true
building_culture_variants_name_wh2_main_special_settlement_gaean_vale_norsca_2wh_main_chs_chaoswh_main_sc_nor_fimir	Occupied Gaean Vale (Warband Camp)	true
building_culture_variants_name_wh2_main_special_settlement_gaean_vale_norsca_3wh_main_chs_chaoswh_main_sc_nor_fimir	Occupied Gaean Vale (Clan Enclave)	true
building_culture_variants_name_wh2_main_special_settlement_gaean_vale_norsca_4wh_main_chs_chaoswh_main_sc_nor_fimir	Occupied Gaean Vale (Tribal Stronghold)	true
building_culture_variants_name_wh2_main_special_settlement_gaean_vale_norsca_5wh_main_chs_chaoswh_main_sc_nor_fimir	Occupied Gaean Vale (Greater Tribal Stronghold)	true
building_culture_variants_name_wh2_main_special_settlement_miragliano_norsca_1wh_main_chs_chaoswh_main_sc_nor_fimir	Occupied Miragliano (Hamlet)	true
building_culture_variants_name_wh2_main_special_settlement_miragliano_norsca_2wh_main_chs_chaoswh_main_sc_nor_fimir	Occupied Miragliano (Village)	true
building_culture_variants_name_wh2_main_special_settlement_miragliano_norsca_3wh_main_chs_chaoswh_main_sc_nor_fimir	Occupied Miragliano (Town)	true
building_culture_variants_name_wh2_main_special_settlement_miragliano_norsca_4wh_main_chs_chaoswh_main_sc_nor_fimir	Occupied Miragliano (City)	true
building_culture_variants_name_wh2_main_special_settlement_miragliano_norsca_5wh_main_chs_chaoswh_main_sc_nor_fimir	Occupied Miragliano (City-State)	true
building_culture_variants_name_wh2_main_foreign_slot_discovery_nor_1wh_main_chs_chaoswh_main_sc_nor_fimir	Marauder Patrols	true
building_culture_variants_name_wh_main_nor_erengrad_uniquewh_main_chs_chaoswh_main_sc_nor_fimir	Cave of the Rocky Throne	true
building_culture_variants_name_wh2_main_special_settlement_kislev_norsca_1wh_main_chs_chaoswh_main_sc_nor_fimir	Occupied Kislev (Hamlet)	true
building_culture_variants_name_wh2_main_special_settlement_kislev_norsca_2wh_main_chs_chaoswh_main_sc_nor_fimir	Occupied Kislev (Village)	true
building_culture_variants_name_wh2_main_special_settlement_kislev_norsca_3wh_main_chs_chaoswh_main_sc_nor_fimir	Occupied Kislev (Town)	true
building_culture_variants_name_wh2_main_special_settlement_kislev_norsca_4wh_main_chs_chaoswh_main_sc_nor_fimir	Occupied Kislev (City)	true
building_culture_variants_name_wh2_main_special_settlement_kislev_norsca_5wh_main_chs_chaoswh_main_sc_nor_fimir	Occupied Kislev (City-State)	true
building_culture_variants_name_wh2_main_special_settlement_lahmia_norsca_1wh_main_chs_chaoswh_main_sc_nor_fimir	Occupied Lahmia (Warrior Gathering)	true
building_culture_variants_name_wh2_main_special_settlement_lahmia_norsca_2wh_main_chs_chaoswh_main_sc_nor_fimir	Occupied Lahmia (Warband Camp)	true
building_culture_variants_name_wh2_main_special_settlement_lahmia_norsca_3wh_main_chs_chaoswh_main_sc_nor_fimir	Occupied Lahmia (Clan Enclave)	true
building_culture_variants_name_wh2_main_special_settlement_lahmia_norsca_4wh_main_chs_chaoswh_main_sc_nor_fimir	Occupied Lahmia (Tribal Stronghold)	true
building_culture_variants_name_wh2_main_special_settlement_lahmia_norsca_5wh_main_chs_chaoswh_main_sc_nor_fimir	Occupied Lahmia (Greater Tribal Stronghold)	true
building_culture_variants_name_wh2_main_special_settlement_khemri_norsca_1wh_main_chs_chaoswh_main_sc_nor_fimir	Occupied Khemri (Warrior Gathering)	true
building_culture_variants_name_wh2_main_special_settlement_khemri_norsca_2wh_main_chs_chaoswh_main_sc_nor_fimir	Occupied Khemri (Warband Camp)	true
building_culture_variants_name_wh2_main_special_settlement_khemri_norsca_3wh_main_chs_chaoswh_main_sc_nor_fimir	Occupied Khemri (Clan Enclave)	true
building_culture_variants_name_wh2_main_special_settlement_khemri_norsca_4wh_main_chs_chaoswh_main_sc_nor_fimir	Occupied Khemri (Tribal Stronghold)	true
building_culture_variants_name_wh2_main_special_settlement_khemri_norsca_5wh_main_chs_chaoswh_main_sc_nor_fimir	Occupied Khemri (Greater Tribal Stronghold)	true
building_culture_variants_name_wh_dlc08_nor_resource_marble_1wh_main_chs_chaoswh_main_sc_nor_fimir	Marble Quarry	true
building_culture_variants_name_wh_dlc08_special_bordeleaux_port_norsca_1wh_main_chs_chaoswh_main_sc_nor_fimir	Bordeleaux Port	true
building_culture_variants_name_wh_dlc08_special_erengrad_port_norsca_1wh_main_chs_chaoswh_main_sc_nor_fimir	Erengrad Docks	true
building_culture_variants_name_wh_dlc08_special_marienburg_port_norsca_1wh_main_chs_chaoswh_main_sc_nor_fimir	Marienburg Docks	true
building_culture_variants_name_wh_main_special_settlement_black_crag_5_norscawh_main_chs_chaoswh_main_sc_nor_fimir	Occupied Black Crag/Karak Drazh (Great Hold)	true
building_culture_variants_name_wh_main_special_settlement_black_crag_4_norscawh_main_chs_chaoswh_main_sc_nor_fimir	Occupied Black Crag/Karak Drazh (Dwarfhold)	true
building_culture_variants_name_wh2_main_special_settlement_altdorf_norsca_1wh_main_chs_chaoswh_main_sc_nor_fimir	Occupied Altdorf (Hamlet)	true
building_culture_variants_name_wh2_main_special_settlement_altdorf_norsca_2wh_main_chs_chaoswh_main_sc_nor_fimir	Occupied Altdorf (Village)	true
building_culture_variants_name_wh2_main_special_settlement_altdorf_norsca_3wh_main_chs_chaoswh_main_sc_nor_fimir	Occupied Altdorf (Town)	true
building_culture_variants_name_wh2_main_special_settlement_altdorf_norsca_4wh_main_chs_chaoswh_main_sc_nor_fimir	Occupied Altdorf (City)	true
building_culture_variants_name_wh2_main_special_settlement_altdorf_norsca_5wh_main_chs_chaoswh_main_sc_nor_fimir	Occupied Altdorf (City-State)	true
building_culture_variants_name_wh_main_special_settlement_black_crag_3_norscawh_main_chs_chaoswh_main_sc_nor_fimir	Occupied Black Crag/Karak Drazh (Dwarf Keep)	true
building_culture_variants_name_wh2_main_special_settlement_hexoatl_norsca_1wh_main_chs_chaoswh_main_sc_nor_fimir	Occupied Hexoatl (Warrior Gathering)	true
building_culture_variants_name_wh2_main_special_settlement_hexoatl_norsca_2wh_main_chs_chaoswh_main_sc_nor_fimir	Occupied Hexoatl (Warband Camp)	true
building_culture_variants_name_wh2_main_special_settlement_hexoatl_norsca_3wh_main_chs_chaoswh_main_sc_nor_fimir	Occupied Hexoatl (Clan Enclave)	true
building_culture_variants_name_wh2_main_special_settlement_hexoatl_norsca_4wh_main_chs_chaoswh_main_sc_nor_fimir	Occupied Hexoatl (Tribal Stronghold)	true
building_culture_variants_name_wh2_main_special_settlement_hexoatl_norsca_5wh_main_chs_chaoswh_main_sc_nor_fimir	Occupied Hexoatl (Greater Tribal Stronghold)	true
building_culture_variants_name_wh2_main_special_settlement_lothern_norsca_1wh_main_chs_chaoswh_main_sc_nor_fimir	Occupied Lothern (Warrior Gathering)	true
building_culture_variants_name_wh2_main_special_settlement_lothern_norsca_2wh_main_chs_chaoswh_main_sc_nor_fimir	Occupied Lothern (Warband Camp)	true
building_culture_variants_name_wh2_main_special_settlement_lothern_norsca_3wh_main_chs_chaoswh_main_sc_nor_fimir	Occupied Lothern (Clan Enclave)	true
building_culture_variants_name_wh2_main_special_settlement_lothern_norsca_4wh_main_chs_chaoswh_main_sc_nor_fimir	Occupied Lothern (Tribal Stronghold)	true
building_culture_variants_name_wh2_main_special_settlement_lothern_norsca_5wh_main_chs_chaoswh_main_sc_nor_fimir	Occupied Lothern (Greater Tribal Stronghold)	true
building_culture_variants_name_wh_main_special_settlement_black_crag_2_norscawh_main_chs_chaoswh_main_sc_nor_fimir	Occupied Black Crag/Karak Drazh (Outpost)	true
building_culture_variants_name_wh2_main_special_settlement_skavenblight_norsca_1wh_main_chs_chaoswh_main_sc_nor_fimir	Occupied Skavenblight (Warrior Gathering)	true
building_culture_variants_name_wh2_main_special_settlement_skavenblight_norsca_2wh_main_chs_chaoswh_main_sc_nor_fimir	Occupied Skavenblight (Warband Camp)	true
building_culture_variants_name_wh2_main_special_settlement_skavenblight_norsca_3wh_main_chs_chaoswh_main_sc_nor_fimir	Occupied Skavenblight (Clan Enclave)	true
building_culture_variants_name_wh2_main_special_settlement_skavenblight_norsca_4wh_main_chs_chaoswh_main_sc_nor_fimir	Occupied Skavenblight (Tribal Stronghold)	true
building_culture_variants_name_wh2_main_special_settlement_skavenblight_norsca_5wh_main_chs_chaoswh_main_sc_nor_fimir	Occupied Skavenblight (Greater Tribal Stronghold)	true
building_culture_variants_name_wh_main_special_settlement_black_crag_1_norscawh_main_chs_chaoswh_main_sc_nor_fimir	Occupied Black Crag/Karak Drazh (Mining Settlement)	true
building_culture_variants_name_wh_main_special_settlement_eight_peaks_4_norscawh_main_chs_chaoswh_main_sc_nor_fimir	Occupied Karak Eight Peaks (Dwarfhold)	true
building_culture_variants_name_wh_main_special_settlement_eight_peaks_5_norscawh_main_chs_chaoswh_main_sc_nor_fimir	Occupied Karak Eight Peaks (Great Hold)	true
building_culture_variants_name_wh_main_special_settlement_eight_peaks_2_norscawh_main_chs_chaoswh_main_sc_nor_fimir	Occupied Karak Eight Peaks (Outpost)	true
building_culture_variants_name_wh_main_special_settlement_eight_peaks_3_norscawh_main_chs_chaoswh_main_sc_nor_fimir	Occupied Karak Eight Peaks (Dwarf Keep)	true
building_culture_variants_name_wh_main_special_settlement_eight_peaks_1_norscawh_main_chs_chaoswh_main_sc_nor_fimir	Occupied Karak Eight Peaks (Mining Settlement)	true
building_culture_variants_name_wh2_main_special_lothern_port_norsca_1wh_main_chs_chaoswh_main_sc_nor_fimir	Lothern Port	true
building_culture_variants_name_wh2_main_special_settlement_naggarond_norsca_1wh_main_chs_chaoswh_main_sc_nor_fimir	Occupied Naggarond (Warrior Gathering)	true
building_culture_variants_name_wh2_main_special_settlement_naggarond_norsca_2wh_main_chs_chaoswh_main_sc_nor_fimir	Occupied Naggarond (Warband Camp)	true
building_culture_variants_name_wh2_main_special_settlement_naggarond_norsca_3wh_main_chs_chaoswh_main_sc_nor_fimir	Occupied Naggarond (Clan Enclave)	true
building_culture_variants_name_wh2_main_special_settlement_naggarond_norsca_4wh_main_chs_chaoswh_main_sc_nor_fimir	Occupied Naggarond (Tribal Stronghold)	true
building_culture_variants_name_wh2_main_special_settlement_naggarond_norsca_5wh_main_chs_chaoswh_main_sc_nor_fimir	Occupied Naggarond (Greater Tribal Stronghold)	true
building_culture_variants_name_wh2_main_special_settlement_sartosa_norsca_1wh_main_chs_chaoswh_main_sc_nor_fimir	Occupied Sartosa Level 1	true
building_culture_variants_name_wh2_main_special_settlement_sartosa_norsca_2wh_main_chs_chaoswh_main_sc_nor_fimir	Occupied Sartosa Level 2	true
building_culture_variants_name_wh2_main_special_settlement_sartosa_norsca_3wh_main_chs_chaoswh_main_sc_nor_fimir	Occupied Sartosa Level 3	true
building_culture_variants_name_wh2_main_special_settlement_sartosa_norsca_4wh_main_chs_chaoswh_main_sc_nor_fimir	Occupied Sartosa Level 4	true
building_culture_variants_name_wh2_main_special_settlement_sartosa_norsca_5wh_main_chs_chaoswh_main_sc_nor_fimir	Occupied Sartosa Level 5	true
building_culture_variants_name_wh2_main_special_settlement_itza_norsca_1wh_main_chs_chaoswh_main_sc_nor_fimir	Occupied Itza (Warrior Gathering)	true
building_culture_variants_name_wh2_main_special_settlement_itza_norsca_2wh_main_chs_chaoswh_main_sc_nor_fimir	Occupied Itza (Warband Camp)	true
building_culture_variants_name_wh2_main_special_settlement_itza_norsca_3wh_main_chs_chaoswh_main_sc_nor_fimir	Occupied Itza (Clan Enclave)	true
building_culture_variants_name_wh2_main_special_settlement_itza_norsca_4wh_main_chs_chaoswh_main_sc_nor_fimir	Occupied Itza (Tribal Stronghold)	true
building_culture_variants_name_wh2_main_special_settlement_itza_norsca_5wh_main_chs_chaoswh_main_sc_nor_fimir	Occupied Itza (Greater Tribal Stronghold)	true
building_culture_variants_name_wh2_main_special_settlement_hellpit_norsca_1wh_main_chs_chaoswh_main_sc_nor_fimir	Occupied Hellpit (Warrior Gathering)	true
building_culture_variants_name_wh2_main_special_settlement_hellpit_norsca_2wh_main_chs_chaoswh_main_sc_nor_fimir	Occupied Hellpit (Warband Camp)	true
building_culture_variants_name_wh2_main_special_settlement_hellpit_norsca_3wh_main_chs_chaoswh_main_sc_nor_fimir	Occupied Hellpit (Clan Enclave)	true
building_culture_variants_name_wh2_main_special_settlement_hellpit_norsca_4wh_main_chs_chaoswh_main_sc_nor_fimir	Occupied Hellpit (Tribal Stronghold)	true
building_culture_variants_name_wh2_main_special_settlement_hellpit_norsca_5wh_main_chs_chaoswh_main_sc_nor_fimir	Occupied Hellpit (Greater Tribal Stronghold)	true
building_culture_variants_name_wh_dlc08_nor_resource_iron_1wh_main_chs_chaoswh_main_sc_nor_fimir	Iron Mine	true
building_culture_variants_name_wh_main_emp_cha_grudge_recruit_1wh2_main_emp_grudgebringers	Press-Gang Wagon	true
building_culture_variants_name_wh_main_emp_cha_grudge_recruit_2wh2_main_emp_grudgebringers	Conscripter Wagon	true
building_culture_variants_name_wh_main_emp_cha_grudge_recruit_3wh2_main_emp_grudgebringers	Mercenary Contractor Wagon	true
building_culture_variants_name_wh_main_emp_cha_grudge_wizard_1wh2_main_emp_grudgebringers	Wizard's Cart	true
building_culture_variants_name_wh_main_emp_cha_grudge_wizard_2wh2_main_emp_grudgebringers	Wizards Stall	true
building_culture_variants_name_wh_main_emp_cha_grudge_worshipwh2_main_emp_grudgebringers	Sigmar Altar	true
building_culture_variants_name_wh_main_emp_cha_grudge_growth_1wh2_main_emp_grudgebringers	Scouts Post	true
building_culture_variants_name_wh_main_emp_cha_grudge_growth_2wh2_main_emp_grudgebringers	Hunter's Lodge	true
building_culture_variants_name_wh_main_emp_cha_grudge_growth_3wh2_main_emp_grudgebringers	Ranger's Outpost	true
building_culture_variants_name_wh_main_emp_cha_grudge_paymasterwh2_main_emp_grudgebringers	Paymaster Wagon	true
building_culture_variants_name_wh_main_emp_cha_grudge_bankwh2_main_emp_grudgebringers	Camp Blacksmith	true
building_culture_variants_name_wh_main_emp_cha_grudge_herowh2_main_emp_grudgebringers	Trader	true
building_culture_variants_name_wh_main_emp_cha_grudge_main_1wh2_main_emp_grudgebringers	Small Camp	true
building_culture_variants_name_wh_main_emp_cha_grudge_main_2wh2_main_emp_grudgebringers	Camp	true
building_culture_variants_name_wh_main_emp_cha_grudge_main_3wh2_main_emp_grudgebringers	War Camp	true
building_culture_variants_name_wh_main_emp_cha_grudge_main_4wh2_main_emp_grudgebringers	Camp Fort	true
building_culture_variants_name_wh_main_emp_cha_grudge_main_5wh2_main_emp_grudgebringers	Wagon Fort	true
building_culture_variants_name_wh_main_emp_farm_basic_1wh2_main_emp_grudgebringers	Barber Surgeon	false
building_culture_variants_name_wh_main_emp_farm_basic_2wh2_main_emp_grudgebringers	Aid Station	false
building_culture_variants_name_wh_main_emp_farm_basic_3wh2_main_emp_grudgebringers	Field Hospital	false
building_culture_variants_name_wh_main_emp_settlement_major_3_coastwh2_main_emp_grudgebringers	Large Outpost	true
building_culture_variants_name_wh_main_emp_settlement_major_2_coastwh2_main_emp_grudgebringers	Outpost	true
building_culture_variants_name_wh_main_emp_settlement_major_1_coastwh2_main_emp_grudgebringers	Small Outpost	true
building_culture_variants_name_wh_main_emp_settlement_major_5_coastwh2_main_emp_grudgebringers	Sprawling Outpost	true
building_culture_variants_name_wh_main_emp_settlement_major_4_coastwh2_main_emp_grudgebringers	Bustling Outpost	true
building_culture_variants_name_wh_main_emp_settlement_minor_3_coastwh2_main_emp_grudgebringers	Large Outpost	true
building_culture_variants_name_wh_main_emp_settlement_minor_2_coastwh2_main_emp_grudgebringers	Outpost	true
building_culture_variants_name_wh_main_emp_settlement_minor_1_coastwh2_main_emp_grudgebringers	Small Outpost	true
building_culture_variants_name_wh_main_emp_settlement_major_1wh2_main_emp_grudgebringers	Small Outpost	true
building_culture_variants_name_wh_main_emp_settlement_major_2wh2_main_emp_grudgebringers	Outpost	true
building_culture_variants_name_wh_main_emp_settlement_major_3wh2_main_emp_grudgebringers	Large Outpost	true
building_culture_variants_name_wh_main_emp_settlement_major_4wh2_main_emp_grudgebringers	Bustling Outpost	true
building_culture_variants_name_wh_main_emp_settlement_major_5wh2_main_emp_grudgebringers	Sprawling Outpost	true
building_culture_variants_name_wh_main_emp_settlement_minor_1wh2_main_emp_grudgebringers	Small Outpost	true
building_culture_variants_name_wh_main_emp_settlement_minor_2wh2_main_emp_grudgebringers	Outpost	true
building_culture_variants_name_wh_main_emp_settlement_minor_3wh2_main_emp_grudgebringers	Large Outpost	true
building_culture_variants_name_wh_main_emp_worship_1wh2_main_emp_grudgebringers	Shrine of Sigmar	true
building_culture_variants_name_ovn_grudge_settlement_recruitwh2_main_emp_grudgebringers	Enlistment Station	false
building_culture_variants_name_ovn_grudge_settlement_smithwh2_main_emp_grudgebringers	Outpost Blacksmith	false
building_culture_variants_name_ovn_grudge_settlement_incomewh2_main_emp_grudgebringers	Trading Post	false
building_culture_variants_name_ovn_grudge_settlement_growth_1wh2_main_emp_grudgebringers	Barber Surgeon	false
building_culture_variants_name_ovn_grudge_settlement_growth_2wh2_main_emp_grudgebringers	Field Hospital	false
building_culture_variants_name_wh_main_emp_industry_basic_2wh_main_emp_empirewh_main_sc_emp_empirewh2_main_emp_the_moot	Tobacco Farm	false
building_culture_variants_name_wh_main_emp_industry_basic_3wh_main_emp_empirewh_main_sc_emp_empirewh2_main_emp_the_moot	Tobacco Plantation	false
building_culture_variants_name_wh_main_emp_industry_basic_1wh_main_emp_empirewh_main_sc_emp_empirewh2_main_emp_the_moot	Tobacco Plot	false
building_culture_variants_name_wh_main_emp_tavern_1wh_main_emp_empirewh_main_sc_emp_empirewh2_main_emp_the_moot	Soup Kitchen	false
building_culture_variants_name_wh_main_emp_tavern_2wh_main_emp_empirewh_main_sc_emp_empirewh2_main_emp_the_moot	Pie Shop	false
building_culture_variants_name_wh_main_emp_tavern_3wh_main_emp_empirewh_main_sc_emp_empirewh2_main_emp_the_moot	Grand Pub	false
building_culture_variants_name_wh_main_emp_forges_1wh2_main_emp_the_moot	Hot-Pot Catapult Workshop	false
building_culture_variants_name_wh_main_emp_forges_2wh2_main_emp_the_moot	Kathleen Soup Tank Workshop	false
building_short_description_texts_short_description_ovn_kath	Halflings scoff at the old slingshots they called catapults, now they are replaced by the real thing.	false
building_short_description_texts_short_description_ovn_kath2	A workshop to tinker with their prized possession and maybe fashion a few catapults. 	false
building_culture_variants_name_wh_main_emp_worship_1wh2_main_emp_the_moot	Shrine of Sigmar	false
building_culture_variants_name_wh_main_emp_worship_2wh2_main_emp_the_moot	Temple of Sigmar	false
building_culture_variants_name_wh_main_emp_worship_3wh2_main_emp_the_moot	PLACEHOLDER	false
building_short_description_texts_short_description_ovn_food_1	Soup, soup, a tasty soup, soup, a spicy carrot and coriander (Chilli chowder). Crouton, crouton, crunchy friends in a liquid broth, I am gazpacho, Oh, I am a summer soup â€“ Traditional Halfling Folk Song	false
building_short_description_texts_short_description_ovn_food_2	While soup is arguably the most popular Halfling dish, pies baked in a buttery crispy crust... buttery flavoured crust, flaky I mean flaky crust is a very close second.	false
building_short_description_texts_short_description_ovn_food_3	A place of food galore and pints of beer, that's right, it comes in pints.	false
building_short_description_texts_short_description_ovn_cig_1	Small tobacco plots dot the land, their owners keep most of the crop while selling any excess at the local markets.	false
building_short_description_texts_short_description_ovn_cig_2	Larger in production, tobacco farms are able to cater to the townsfolk who live in the towns across the Moot including its capital Eicheschatten.	false
building_short_description_texts_short_description_ovn_cig_3	Large scale tobacco cultivation uses large swathes of land damaging local countryside. Through economy of scales they are able to service all of the Empire and beyond, making tobacco a lucrative cash crop.	false
building_culture_variants_name_ovn_hlf_welf_1wh2_main_emp_the_moot	Tangled Grove of Altern	true
building_culture_variants_name_ovn_hlf_welf_2wh2_main_emp_the_moot	Grove of Altern	true
building_culture_variants_name_ovn_hlf_welf_3wh2_main_emp_the_moot	Sacred Grove of Altern	true
building_culture_variants_name_ovn_hlf_cigwh2_main_emp_the_moot	Gipfel Tobacco Barn	true
building_short_description_texts_short_description_ovn_hlf_welf	The Halflings have always been attuned with nature but to shy away from industry and embrace the land is truly a wonderful sight.	true
building_short_description_texts_short_description_ovn_hlf_cig	Halflings have long cultivated tobacco, producing the finest tobaccy throughout the Old World. Gipfel is very much at the heart of this burgeoning industry.	true
building_culture_variants_name_wh_main_emp_wizards_1wh2_main_emp_the_moot	Wizard's Conclave	false
building_chains_chain_tooltip_ovn_Nehekharan	Archaeology	false
building_short_description_texts_short_description_ovn_Nehekharan	Great knowledge and many riches can be gained from the ancient Nehekharan King's tombs. 	false
building_culture_variants_name_ovn_Nehekharanwh_main_sc_emp_araby	Nehekharan Excavation	false
building_chains_chain_tooltip_ovn_Portal_Recruitment	Portal Recruitment	false
building_short_description_texts_short_description_ovn_Portal_Recruitment_0	Fierce norscan tribesmen pour out in droves harkening their Dark Masters call.	false
building_short_description_texts_short_description_ovn_Portal_Recruitment_1	Fimir are no strangers to tearing the fabric of the mortal realm in order to summon demons to their cause.	false
building_short_description_texts_short_description_ovn_Portal_Recruitment_2	Only the brave, foolish or a demon themselves would create a portal of this magnitude to the depths of the Chaos Wastes.	false
building_short_description_texts_short_description_ovn_Portal_Recruitment_3	To see the end times one must merely gaze through the abyss.	false
building_culture_variants_name_ovn_Portal_Recruitment_3wh2_main_nor_harbingers_of_doom	Gateway of Doom	false
building_culture_variants_name_ovn_Portal_Recruitment_2wh2_main_nor_harbingers_of_doom	Dark Masters Portal	false
building_culture_variants_name_ovn_Portal_Recruitment_1wh2_main_nor_harbingers_of_doom	Chaos Rift	false
building_culture_variants_name_ovn_Portal_Recruitment_0wh2_main_nor_harbingers_of_doom	Chaos Tear	false
building_culture_variants_name_ovn_warp_stables_1wh2_main_nor_harbingers_of_doom	Ruinous Stables	true
building_culture_variants_name_ovn_warp_stables_2wh2_main_nor_harbingers_of_doom	Palanquin of Trophies	true
building_culture_variants_name_ovn_warp_stables_3wh2_main_nor_harbingers_of_doom	Pillar of Skulls	true
building_culture_variants_name_ovn_warp_stables_4wh2_main_nor_harbingers_of_doom	Tower of Skulls	true
building_culture_variants_name_ovn_Portal_Recruitment_altwh2_main_nor_servants_of_fimulneid	Chaos Rift	false
building_chains_chain_tooltip_ovn_Waystone	Waystone	false
building_short_description_texts_short_description_ovn_Waystone_1	Unearthed these Waystones are nothing more than ruins covered in moss and tainted by chaos.	false
building_short_description_texts_short_description_ovn_Waystone_2	As the Waystones are slowly repaired Chaos is drained from the world and offers protection to Albion.	false
building_short_description_texts_short_description_ovn_Waystone_3	The waystones surge with power and with it the attention of evil beings.	false
building_culture_variants_name_ovn_Waystone_1wh2_main_nor_albion	Uncovered Waystone	false
building_culture_variants_name_ovn_Waystone_2wh2_main_nor_albion	Pulsing Waystone	false
building_culture_variants_name_ovn_Waystone_3wh2_main_nor_albion	Surging Waystone	false
building_culture_variants_name_ovn_Waystone_markerwh2_main_nor_albion	Waystone Marker	false
building_short_description_texts_short_description_ovn_Waystone_marker	A Waystone Marker helps Druids focus and calibrate the Albion Waystones allowing them to work more effectively.	false
building_culture_variants_name_ovn_Waystone_beaconwh2_main_nor_albion	Waystone Beacon	false
building_short_description_texts_short_description_ovn_Waystone_beacon	Using a shard from the Albion Waystones the druids are able to construct a beacon that can feed from Waystones power even at a great distance, though at the loss of some power.	false
building_culture_variants_name_ovn_fimir_mil_1wh_main_sc_nor_fimir	Fetid Bog	false
building_culture_variants_name_ovn_fimir_mil_2wh_main_sc_nor_fimir	Tangled Swamps	false
building_culture_variants_name_ovn_fimir_mil_3wh_main_sc_nor_fimir	Rotten Marshes	false
building_culture_variants_name_ovn_fimir_mil_4wh_main_sc_nor_fimir	Dark Fen	false
building_culture_variants_name_ovn_fimir_agrul_migdhal_landmarkwh_main_sc_nor_fimir	Marsh Traps	false
building_culture_variants_name_ovn_fimir_nor_1wh_main_sc_nor_fimir	Norscan Glacier	false
building_culture_variants_name_ovn_fimir_beast_1wh_main_sc_nor_fimir	Fimm Snare	false
building_culture_variants_name_ovn_fimir_beast_2wh_main_sc_nor_fimir	Dirach Lure	false
building_culture_variants_name_ovn_fimir_beast_3wh_main_sc_nor_fimir	Dirach Construct	false
building_culture_variants_name_ovn_fimir_income_3wh_main_sc_nor_fimir	Slave Mining Labyrinth	true
building_culture_variants_name_ovn_fimir_income_2wh_main_sc_nor_fimir	Slave Mining Shaft	true
building_culture_variants_name_ovn_fimir_income_1wh_main_sc_nor_fimir	Slave Mining Pit	true
building_culture_variants_name_ovn_fimir_agentwh_main_sc_nor_fimir	Gobbo Shack	true
building_culture_variants_name_wh2_dlc15_special_settlement_massif_orcal_norsca_1wh_main_sc_nor_fimir	Occupied Massif Orcal (Warrior Gathering)	false
building_culture_variants_name_wh2_dlc15_special_settlement_massif_orcal_norsca_2wh_main_sc_nor_fimir	Occupied Massif Orcal (Warband Camp)	false
building_culture_variants_name_wh2_dlc15_special_settlement_massif_orcal_norsca_3wh_main_sc_nor_fimir	Occupied Massif Orcal (Clan Enclave)	false
building_culture_variants_name_wh2_dlc15_special_settlement_massif_orcal_norsca_4wh_main_sc_nor_fimir	Occupied Massif Orcal (Tribal Stronghold)	false
building_culture_variants_name_wh2_dlc15_special_settlement_massif_orcal_norsca_5wh_main_sc_nor_fimir	Occupied Massif Orcal (Greater Tribal Stronghold)	false
building_culture_variants_name_wh2_main_special_settlement_konquata_norsca_4wh_main_sc_nor_fimir	Occupied Konquata (Tribal Stronghold)	true
building_culture_variants_name_wh2_main_special_settlement_konquata_norsca_5wh_main_sc_nor_fimir	Occupied Konquata (Greater Tribal Stronghold)	true
building_culture_variants_name_wh_twa03_special_albion_port_norsca_1wh_main_sc_nor_fimir	Albion Docks	true
building_culture_variants_name_wh2_main_special_settlement_konquata_norsca_3wh_main_sc_nor_fimir	Occupied Konquata (Clan Enclave)	true
building_culture_variants_name_wh2_main_special_settlement_konquata_norsca_1wh_main_sc_nor_fimir	Occupied Konquata (Warrior Gathering)	true
building_culture_variants_name_wh2_main_special_settlement_konquata_norsca_2wh_main_sc_nor_fimir	Occupied Konquata (Warband Camp)	true
building_chains_chain_tooltip_ovn_Animal_Rearing	Animal Rearing	false
building_culture_variants_name_ovn_Animal_Rearing_1wh2_main_emp_the_moot	Pig Pen	false
building_culture_variants_name_ovn_Animal_Rearing_2wh2_main_emp_the_moot	Barnyard	false
building_culture_variants_name_ovn_half_industry_2wh2_main_emp_the_moot	Tobacco Farm	false
building_culture_variants_name_ovn_half_industry_3wh2_main_emp_the_moot	Tobacco Plantation	false
building_culture_variants_name_ovn_half_industry_1wh2_main_emp_the_moot	Tobacco Plot	false
building_short_description_texts_short_description_ovn_Animal_Rearing_1	Pigs under halfling care grow so fat and hearty that in dire times they can be ridden into battle. Some muse the pigs fight with such unexpected fury as only to avoid the plate.	false
building_short_description_texts_short_description_ovn_Animal_Rearing_2	Warhorses are far too unwieldy to a halfling and ponies too gentle. As such specially trained cockerels are reared for the halflings to charge into war on.	false
building_chains_chain_tooltip_ovn_half_dragon	Dragons	false
building_culture_variants_name_ovn_half_dragonwh2_main_emp_the_moot	Dragon Egg Smuggler	false
building_short_description_texts_short_description_ovn_half_dragon	Tricksy little halflings snatch the eggs and are long gone before the mother even realises. As they tumble down the mountains with their prize, her shrieks and wails can be heard across the mountain tops. This trade has it detractors who see it as a cruel practice.	false
building_chains_chain_tooltip_ovn_half_industry	Tobacco	false
building_culture_variants_name_ovn_half_barracks_1wh_main_emp_empirewh_main_sc_emp_empirewh2_main_emp_the_moot	Training Field	true
building_culture_variants_name_ovn_half_barracks_2wh_main_emp_empirewh_main_sc_emp_empirewh2_main_emp_the_moot	Rally Field	true
building_culture_variants_name_ovn_half_barracks_3wh_main_emp_empirewh_main_sc_emp_empirewh2_main_emp_the_moot	Barracks	true
building_culture_variants_name_ovn_half_forges_1wh_main_emp_empirewh_main_sc_emp_empirewh2_main_emp_the_moot	Gunsmith	true
building_culture_variants_name_ovn_half_tavern_1wh_main_emp_empirewh_main_sc_emp_empirewh2_main_emp_the_moot	Tap Room	true
building_culture_variants_name_ovn_half_tavern_2wh_main_emp_empirewh_main_sc_emp_empirewh2_main_emp_the_moot	Tavern	true
building_culture_variants_name_ovn_half_tavern_3wh_main_emp_empirewh_main_sc_emp_empirewh2_main_emp_the_moot	Coaching Inn	true
building_culture_variants_name_ovn_hlf_resource_salt_1wh2_main_emp_the_moot	Salt Mining Pit	true
building_culture_variants_name_ovn_hlf_resource_salt_2wh2_main_emp_the_moot	Salt Mine Shaft	true
building_culture_variants_name_ovn_hlf_resource_salt_3wh2_main_emp_the_moot	Giant Salt Mine Shaft	true
building_culture_variants_name_ovn_evil_income_3wh_main_sc_nor_fimir	Slave Mining Labyrinth	true
building_culture_variants_name_ovn_evil_income_2wh_main_sc_nor_fimir	Slave Mining Shaft	true
building_culture_variants_name_ovn_evil_income_1wh_main_sc_nor_fimir	Slave Mining Pit	true
building_culture_variants_name_ovn_nor_outpost_major_human_4wh_main_sc_nor_fimir	Dark Palace	true
building_culture_variants_name_wh_main_nor_outpost_stables_4wh_main_sc_nor_fimir	Dreaded Mire	true
building_culture_variants_name_ovn_grn_agentwh_main_sc_nor_fimir	Gobbo Shack	true
building_culture_variants_name_ovn_grn_agentwh2_main_nor_trollz	Gobbo Shack	true
building_culture_variants_name_wh2_main_special_settlement_castle_drakenhof_norsca_1wh_main_chs_chaoswh_main_sc_nor_albion	Occupied Drakenhof (Hamlet)	true
building_culture_variants_name_wh2_main_special_settlement_castle_drakenhof_norsca_2wh_main_chs_chaoswh_main_sc_nor_albion	Occupied Drakenhof (Village)	true
building_culture_variants_name_wh2_main_special_settlement_castle_drakenhof_norsca_3wh_main_chs_chaoswh_main_sc_nor_albion	Occupied Drakenhof (Town)	true
building_culture_variants_name_wh2_main_special_settlement_castle_drakenhof_norsca_4wh_main_chs_chaoswh_main_sc_nor_albion	Occupied Drakenhof (City)	true
building_culture_variants_name_wh2_main_special_settlement_castle_drakenhof_norsca_5wh_main_chs_chaoswh_main_sc_nor_albion	Occupied Drakenhof (City-State)	true
building_culture_variants_name_wh_dlc08_nor_resource_obsidian_1wh_main_chs_chaoswh_main_sc_nor_albion	Obsidian Quarry	true
building_culture_variants_name_wh2_main_special_settlement_couronne_norsca_1wh_main_chs_chaoswh_main_sc_nor_albion	Occupied Couronne (Hamlet)	true
building_culture_variants_name_wh2_main_special_settlement_couronne_norsca_2wh_main_chs_chaoswh_main_sc_nor_albion	Occupied Couronne (Village)	true
building_culture_variants_name_wh2_main_special_settlement_couronne_norsca_3wh_main_chs_chaoswh_main_sc_nor_albion	Occupied Couronne (Town)	true
building_culture_variants_name_wh2_main_special_settlement_couronne_norsca_4wh_main_chs_chaoswh_main_sc_nor_albion	Occupied Couronne (City)	true
building_culture_variants_name_wh2_main_special_settlement_couronne_norsca_5wh_main_chs_chaoswh_main_sc_nor_albion	Occupied Couronne (City-State)	true
building_culture_variants_name_wh2_main_special_settlement_the_awakening_norsca_1wh_main_chs_chaoswh_main_sc_nor_albion	Occupied The Awakening Level 1	true
building_culture_variants_name_wh2_main_special_settlement_the_awakening_norsca_2wh_main_chs_chaoswh_main_sc_nor_albion	Occupied The Awakening Level 2	true
building_culture_variants_name_wh2_main_special_settlement_the_awakening_norsca_3wh_main_chs_chaoswh_main_sc_nor_albion	Occupied The Awakening Level 3	true
building_culture_variants_name_wh2_main_special_settlement_the_awakening_norsca_4wh_main_chs_chaoswh_main_sc_nor_albion	Occupied The Awakening Level 4	true
building_culture_variants_name_wh2_main_special_settlement_the_awakening_norsca_5wh_main_chs_chaoswh_main_sc_nor_albion	Occupied The Awakening Level 5	true
building_culture_variants_name_wh_main_special_settlement_karaz_a_karak_5_norscawh_main_chs_chaoswh_main_sc_nor_albion	Occupied Karaz-a-Karak (Great Hold)	true
building_culture_variants_name_wh_main_special_settlement_karaz_a_karak_4_norscawh_main_chs_chaoswh_main_sc_nor_albion	Occupied Karaz-a-Karak (Dwarfhold)	true
building_culture_variants_name_wh_main_special_settlement_karaz_a_karak_3_norscawh_main_chs_chaoswh_main_sc_nor_albion	Occupied Karaz-a-Karak (Dwarf Keep)	true
building_culture_variants_name_wh_main_special_settlement_karaz_a_karak_2_norscawh_main_chs_chaoswh_main_sc_nor_albion	Occupied Karaz-a-Karak (Outpost)	true
building_culture_variants_name_wh_main_special_settlement_karaz_a_karak_1_norscawh_main_chs_chaoswh_main_sc_nor_albion	Occupied Karaz-a-Karak (Mining Settlement)	true
building_culture_variants_name_wh2_main_special_settlement_gaean_vale_norsca_1wh_main_chs_chaoswh_main_sc_nor_albion	Occupied Gaean Vale (Warrior Gathering)	true
building_culture_variants_name_wh2_main_special_settlement_gaean_vale_norsca_2wh_main_chs_chaoswh_main_sc_nor_albion	Occupied Gaean Vale (Warband Camp)	true
building_culture_variants_name_wh2_main_special_settlement_gaean_vale_norsca_3wh_main_chs_chaoswh_main_sc_nor_albion	Occupied Gaean Vale (Clan Enclave)	true
building_culture_variants_name_wh2_main_special_settlement_gaean_vale_norsca_4wh_main_chs_chaoswh_main_sc_nor_albion	Occupied Gaean Vale (Tribal Stronghold)	true
building_culture_variants_name_wh2_main_special_settlement_gaean_vale_norsca_5wh_main_chs_chaoswh_main_sc_nor_albion	Occupied Gaean Vale (Greater Tribal Stronghold)	true
building_culture_variants_name_wh2_main_special_settlement_miragliano_norsca_1wh_main_chs_chaoswh_main_sc_nor_albion	Occupied Miragliano (Hamlet)	true
building_culture_variants_name_wh2_main_special_settlement_miragliano_norsca_2wh_main_chs_chaoswh_main_sc_nor_albion	Occupied Miragliano (Village)	true
building_culture_variants_name_wh2_main_special_settlement_miragliano_norsca_3wh_main_chs_chaoswh_main_sc_nor_albion	Occupied Miragliano (Town)	true
building_culture_variants_name_wh2_main_special_settlement_miragliano_norsca_4wh_main_chs_chaoswh_main_sc_nor_albion	Occupied Miragliano (City)	true
building_culture_variants_name_wh2_main_special_settlement_miragliano_norsca_5wh_main_chs_chaoswh_main_sc_nor_albion	Occupied Miragliano (City-State)	true
building_culture_variants_name_wh2_main_foreign_slot_discovery_nor_1wh_main_chs_chaoswh_main_sc_nor_albion	Tribal Patrols	true
building_culture_variants_name_wh2_main_special_settlement_kislev_norsca_1wh_main_chs_chaoswh_main_sc_nor_albion	Occupied Kislev (Hamlet)	true
building_culture_variants_name_wh2_main_special_settlement_kislev_norsca_2wh_main_chs_chaoswh_main_sc_nor_albion	Occupied Kislev (Village)	true
building_culture_variants_name_wh2_main_special_settlement_kislev_norsca_3wh_main_chs_chaoswh_main_sc_nor_albion	Occupied Kislev (Town)	true
building_culture_variants_name_wh2_main_special_settlement_kislev_norsca_4wh_main_chs_chaoswh_main_sc_nor_albion	Occupied Kislev (City)	true
building_culture_variants_name_wh2_main_special_settlement_kislev_norsca_5wh_main_chs_chaoswh_main_sc_nor_albion	Occupied Kislev (City-State)	true
building_culture_variants_name_wh2_main_special_settlement_lahmia_norsca_1wh_main_chs_chaoswh_main_sc_nor_albion	Occupied Lahmia (Warrior Gathering)	true
building_culture_variants_name_wh2_main_special_settlement_lahmia_norsca_2wh_main_chs_chaoswh_main_sc_nor_albion	Occupied Lahmia (Warband Camp)	true
building_culture_variants_name_wh2_main_special_settlement_lahmia_norsca_3wh_main_chs_chaoswh_main_sc_nor_albion	Occupied Lahmia (Clan Enclave)	true
building_culture_variants_name_wh2_main_special_settlement_lahmia_norsca_4wh_main_chs_chaoswh_main_sc_nor_albion	Occupied Lahmia (Tribal Stronghold)	true
building_culture_variants_name_wh2_main_special_settlement_lahmia_norsca_5wh_main_chs_chaoswh_main_sc_nor_albion	Occupied Lahmia (Greater Tribal Stronghold)	true
building_culture_variants_name_wh2_main_special_settlement_khemri_norsca_1wh_main_chs_chaoswh_main_sc_nor_albion	Occupied Khemri (Warrior Gathering)	true
building_culture_variants_name_wh2_main_special_settlement_khemri_norsca_2wh_main_chs_chaoswh_main_sc_nor_albion	Occupied Khemri (Warband Camp)	true
building_culture_variants_name_wh2_main_special_settlement_khemri_norsca_3wh_main_chs_chaoswh_main_sc_nor_albion	Occupied Khemri (Clan Enclave)	true
building_culture_variants_name_wh2_main_special_settlement_khemri_norsca_4wh_main_chs_chaoswh_main_sc_nor_albion	Occupied Khemri (Tribal Stronghold)	true
building_culture_variants_name_wh2_main_special_settlement_khemri_norsca_5wh_main_chs_chaoswh_main_sc_nor_albion	Occupied Khemri (Greater Tribal Stronghold)	true
building_culture_variants_name_wh_dlc08_nor_resource_marble_1wh_main_chs_chaoswh_main_sc_nor_albion	Marble Quarry	true
building_culture_variants_name_wh_dlc08_special_bordeleaux_port_norsca_1wh_main_chs_chaoswh_main_sc_nor_albion	Bordeleaux Port	true
building_culture_variants_name_wh_dlc08_special_erengrad_port_norsca_1wh_main_chs_chaoswh_main_sc_nor_albion	Erengrad Docks	true
building_culture_variants_name_wh_dlc08_special_marienburg_port_norsca_1wh_main_chs_chaoswh_main_sc_nor_albion	Marienburg Docks	true
building_culture_variants_name_wh_main_special_settlement_black_crag_5_norscawh_main_chs_chaoswh_main_sc_nor_albion	Occupied Black Crag/Karak Drazh (Great Hold)	true
building_culture_variants_name_wh_main_special_settlement_black_crag_4_norscawh_main_chs_chaoswh_main_sc_nor_albion	Occupied Black Crag/Karak Drazh (Dwarfhold)	true
building_culture_variants_name_wh2_main_special_settlement_altdorf_norsca_1wh_main_chs_chaoswh_main_sc_nor_albion	Occupied Altdorf (Hamlet)	true
building_culture_variants_name_wh2_main_special_settlement_altdorf_norsca_2wh_main_chs_chaoswh_main_sc_nor_albion	Occupied Altdorf (Village)	true
building_culture_variants_name_wh2_main_special_settlement_altdorf_norsca_3wh_main_chs_chaoswh_main_sc_nor_albion	Occupied Altdorf (Town)	true
building_culture_variants_name_wh2_main_special_settlement_altdorf_norsca_4wh_main_chs_chaoswh_main_sc_nor_albion	Occupied Altdorf (City)	true
building_culture_variants_name_wh2_main_special_settlement_altdorf_norsca_5wh_main_chs_chaoswh_main_sc_nor_albion	Occupied Altdorf (City-State)	true
building_culture_variants_name_wh_main_special_settlement_black_crag_3_norscawh_main_chs_chaoswh_main_sc_nor_albion	Occupied Black Crag/Karak Drazh (Dwarf Keep)	true
building_culture_variants_name_wh2_main_special_settlement_hexoatl_norsca_1wh_main_chs_chaoswh_main_sc_nor_albion	Occupied Hexoatl (Warrior Gathering)	true
building_culture_variants_name_wh2_main_special_settlement_hexoatl_norsca_2wh_main_chs_chaoswh_main_sc_nor_albion	Occupied Hexoatl (Warband Camp)	true
building_culture_variants_name_wh2_main_special_settlement_hexoatl_norsca_3wh_main_chs_chaoswh_main_sc_nor_albion	Occupied Hexoatl (Clan Enclave)	true
building_culture_variants_name_wh2_main_special_settlement_hexoatl_norsca_4wh_main_chs_chaoswh_main_sc_nor_albion	Occupied Hexoatl (Tribal Stronghold)	true
building_culture_variants_name_wh2_main_special_settlement_hexoatl_norsca_5wh_main_chs_chaoswh_main_sc_nor_albion	Occupied Hexoatl (Greater Tribal Stronghold)	true
building_culture_variants_name_wh2_main_special_settlement_lothern_norsca_1wh_main_chs_chaoswh_main_sc_nor_albion	Occupied Lothern (Warrior Gathering)	true
building_culture_variants_name_wh2_main_special_settlement_lothern_norsca_2wh_main_chs_chaoswh_main_sc_nor_albion	Occupied Lothern (Warband Camp)	true
building_culture_variants_name_wh2_main_special_settlement_lothern_norsca_3wh_main_chs_chaoswh_main_sc_nor_albion	Occupied Lothern (Clan Enclave)	true
building_culture_variants_name_wh2_main_special_settlement_lothern_norsca_4wh_main_chs_chaoswh_main_sc_nor_albion	Occupied Lothern (Tribal Stronghold)	true
building_culture_variants_name_wh2_main_special_settlement_lothern_norsca_5wh_main_chs_chaoswh_main_sc_nor_albion	Occupied Lothern (Greater Tribal Stronghold)	true
building_culture_variants_name_wh_main_special_settlement_black_crag_2_norscawh_main_chs_chaoswh_main_sc_nor_albion	Occupied Black Crag/Karak Drazh (Outpost)	true
building_culture_variants_name_wh2_main_special_settlement_skavenblight_norsca_1wh_main_chs_chaoswh_main_sc_nor_albion	Occupied Skavenblight (Warrior Gathering)	true
building_culture_variants_name_wh2_main_special_settlement_skavenblight_norsca_2wh_main_chs_chaoswh_main_sc_nor_albion	Occupied Skavenblight (Warband Camp)	true
building_culture_variants_name_wh2_main_special_settlement_skavenblight_norsca_3wh_main_chs_chaoswh_main_sc_nor_albion	Occupied Skavenblight (Clan Enclave)	true
building_culture_variants_name_wh2_main_special_settlement_skavenblight_norsca_4wh_main_chs_chaoswh_main_sc_nor_albion	Occupied Skavenblight (Tribal Stronghold)	true
building_culture_variants_name_wh2_main_special_settlement_skavenblight_norsca_5wh_main_chs_chaoswh_main_sc_nor_albion	Occupied Skavenblight (Greater Tribal Stronghold)	true
building_culture_variants_name_wh_main_special_settlement_black_crag_1_norscawh_main_chs_chaoswh_main_sc_nor_albion	Occupied Black Crag/Karak Drazh (Mining Settlement)	true
building_culture_variants_name_wh_main_special_settlement_eight_peaks_4_norscawh_main_chs_chaoswh_main_sc_nor_albion	Occupied Karak Eight Peaks (Dwarfhold)	true
building_culture_variants_name_wh_main_special_settlement_eight_peaks_5_norscawh_main_chs_chaoswh_main_sc_nor_albion	Occupied Karak Eight Peaks (Great Hold)	true
building_culture_variants_name_wh_main_special_settlement_eight_peaks_2_norscawh_main_chs_chaoswh_main_sc_nor_albion	Occupied Karak Eight Peaks (Outpost)	true
building_culture_variants_name_wh_main_special_settlement_eight_peaks_3_norscawh_main_chs_chaoswh_main_sc_nor_albion	Occupied Karak Eight Peaks (Dwarf Keep)	true
building_culture_variants_name_wh_main_special_settlement_eight_peaks_1_norscawh_main_chs_chaoswh_main_sc_nor_albion	Occupied Karak Eight Peaks (Mining Settlement)	true
building_culture_variants_name_wh2_main_special_lothern_port_norsca_1wh_main_chs_chaoswh_main_sc_nor_albion	Lothern Port	true
building_culture_variants_name_wh2_main_special_settlement_naggarond_norsca_1wh_main_chs_chaoswh_main_sc_nor_albion	Occupied Naggarond (Warrior Gathering)	true
building_culture_variants_name_wh2_main_special_settlement_naggarond_norsca_2wh_main_chs_chaoswh_main_sc_nor_albion	Occupied Naggarond (Warband Camp)	true
building_culture_variants_name_wh2_main_special_settlement_naggarond_norsca_3wh_main_chs_chaoswh_main_sc_nor_albion	Occupied Naggarond (Clan Enclave)	true
building_culture_variants_name_wh2_main_special_settlement_naggarond_norsca_4wh_main_chs_chaoswh_main_sc_nor_albion	Occupied Naggarond (Tribal Stronghold)	true
building_culture_variants_name_wh2_main_special_settlement_naggarond_norsca_5wh_main_chs_chaoswh_main_sc_nor_albion	Occupied Naggarond (Greater Tribal Stronghold)	true
building_culture_variants_name_wh2_main_special_settlement_sartosa_norsca_1wh_main_chs_chaoswh_main_sc_nor_albion	Occupied Sartosa Level 1	true
building_culture_variants_name_wh2_main_special_settlement_sartosa_norsca_2wh_main_chs_chaoswh_main_sc_nor_albion	Occupied Sartosa Level 2	true
building_culture_variants_name_wh2_main_special_settlement_sartosa_norsca_3wh_main_chs_chaoswh_main_sc_nor_albion	Occupied Sartosa Level 3	true
building_culture_variants_name_wh2_main_special_settlement_sartosa_norsca_4wh_main_chs_chaoswh_main_sc_nor_albion	Occupied Sartosa Level 4	true
building_culture_variants_name_wh2_main_special_settlement_sartosa_norsca_5wh_main_chs_chaoswh_main_sc_nor_albion	Occupied Sartosa Level 5	true
building_culture_variants_name_wh2_main_special_settlement_itza_norsca_1wh_main_chs_chaoswh_main_sc_nor_albion	Occupied Itza (Warrior Gathering)	true
building_culture_variants_name_wh2_main_special_settlement_itza_norsca_2wh_main_chs_chaoswh_main_sc_nor_albion	Occupied Itza (Warband Camp)	true
building_culture_variants_name_wh2_main_special_settlement_itza_norsca_3wh_main_chs_chaoswh_main_sc_nor_albion	Occupied Itza (Clan Enclave)	true
building_culture_variants_name_wh2_main_special_settlement_itza_norsca_4wh_main_chs_chaoswh_main_sc_nor_albion	Occupied Itza (Tribal Stronghold)	true
building_culture_variants_name_wh2_main_special_settlement_itza_norsca_5wh_main_chs_chaoswh_main_sc_nor_albion	Occupied Itza (Greater Tribal Stronghold)	true
building_culture_variants_name_wh2_main_special_settlement_hellpit_norsca_1wh_main_chs_chaoswh_main_sc_nor_albion	Occupied Hellpit (Warrior Gathering)	true
building_culture_variants_name_wh2_main_special_settlement_hellpit_norsca_2wh_main_chs_chaoswh_main_sc_nor_albion	Occupied Hellpit (Warband Camp)	true
building_culture_variants_name_wh2_main_special_settlement_hellpit_norsca_3wh_main_chs_chaoswh_main_sc_nor_albion	Occupied Hellpit (Clan Enclave)	true
building_culture_variants_name_wh2_main_special_settlement_hellpit_norsca_4wh_main_chs_chaoswh_main_sc_nor_albion	Occupied Hellpit (Tribal Stronghold)	true
building_culture_variants_name_wh2_main_special_settlement_hellpit_norsca_5wh_main_chs_chaoswh_main_sc_nor_albion	Occupied Hellpit (Greater Tribal Stronghold)	true
building_culture_variants_name_wh_dlc08_nor_resource_iron_1wh_main_chs_chaoswh_main_sc_nor_albion	Iron Mine	true
building_culture_variants_name_wh2_main_special_settlement_castle_drakenhof_norsca_1wh_main_sc_nor_albion	Occupied Drakenhof (Hamlet)	true
building_culture_variants_name_wh2_main_special_settlement_castle_drakenhof_norsca_2wh_main_sc_nor_albion	Occupied Drakenhof (Village)	true
building_culture_variants_name_wh2_main_special_settlement_castle_drakenhof_norsca_3wh_main_sc_nor_albion	Occupied Drakenhof (Town)	true
building_culture_variants_name_wh2_main_special_settlement_castle_drakenhof_norsca_4wh_main_sc_nor_albion	Occupied Drakenhof (City)	true
building_culture_variants_name_wh2_main_special_settlement_castle_drakenhof_norsca_5wh_main_sc_nor_albion	Occupied Drakenhof (City-State)	true
building_culture_variants_name_wh_dlc08_nor_resource_obsidian_1wh_main_sc_nor_albion	Obsidian Quarry	true
building_culture_variants_name_wh2_main_special_settlement_couronne_norsca_1wh_main_sc_nor_albion	Occupied Couronne (Hamlet)	true
building_culture_variants_name_wh2_main_special_settlement_couronne_norsca_2wh_main_sc_nor_albion	Occupied Couronne (Village)	true
building_culture_variants_name_wh2_main_special_settlement_couronne_norsca_3wh_main_sc_nor_albion	Occupied Couronne (Town)	true
building_culture_variants_name_wh2_main_special_settlement_couronne_norsca_4wh_main_sc_nor_albion	Occupied Couronne (City)	true
building_culture_variants_name_wh2_main_special_settlement_couronne_norsca_5wh_main_sc_nor_albion	Occupied Couronne (City-State)	true
building_culture_variants_name_wh2_main_special_settlement_the_awakening_norsca_1wh_main_sc_nor_albion	Occupied The Awakening Level 1	true
building_culture_variants_name_wh2_main_special_settlement_the_awakening_norsca_2wh_main_sc_nor_albion	Occupied The Awakening Level 2	true
building_culture_variants_name_wh2_main_special_settlement_the_awakening_norsca_3wh_main_sc_nor_albion	Occupied The Awakening Level 3	true
building_culture_variants_name_wh2_main_special_settlement_the_awakening_norsca_4wh_main_sc_nor_albion	Occupied The Awakening Level 4	true
building_culture_variants_name_wh2_main_special_settlement_the_awakening_norsca_5wh_main_sc_nor_albion	Occupied The Awakening Level 5	true
building_culture_variants_name_wh_main_special_settlement_karaz_a_karak_5_norscawh_main_sc_nor_albion	Occupied Karaz-a-Karak (Great Hold)	true
building_culture_variants_name_wh_main_special_settlement_karaz_a_karak_4_norscawh_main_sc_nor_albion	Occupied Karaz-a-Karak (Dwarfhold)	true
building_culture_variants_name_wh_main_special_settlement_karaz_a_karak_3_norscawh_main_sc_nor_albion	Occupied Karaz-a-Karak (Dwarf Keep)	true
building_culture_variants_name_wh_main_special_settlement_karaz_a_karak_2_norscawh_main_sc_nor_albion	Occupied Karaz-a-Karak (Outpost)	true
building_culture_variants_name_wh_main_special_settlement_karaz_a_karak_1_norscawh_main_sc_nor_albion	Occupied Karaz-a-Karak (Mining Settlement)	true
building_culture_variants_name_wh2_main_special_settlement_gaean_vale_norsca_1wh_main_sc_nor_albion	Occupied Gaean Vale (Warrior Gathering)	true
building_culture_variants_name_wh2_main_special_settlement_gaean_vale_norsca_2wh_main_sc_nor_albion	Occupied Gaean Vale (Warband Camp)	true
building_culture_variants_name_wh2_main_special_settlement_gaean_vale_norsca_3wh_main_sc_nor_albion	Occupied Gaean Vale (Clan Enclave)	true
building_culture_variants_name_wh2_main_special_settlement_gaean_vale_norsca_4wh_main_sc_nor_albion	Occupied Gaean Vale (Tribal Stronghold)	true
building_culture_variants_name_wh2_main_special_settlement_gaean_vale_norsca_5wh_main_sc_nor_albion	Occupied Gaean Vale (Greater Tribal Stronghold)	true
building_culture_variants_name_wh2_main_special_settlement_miragliano_norsca_1wh_main_sc_nor_albion	Occupied Miragliano (Hamlet)	true
building_culture_variants_name_wh2_main_special_settlement_miragliano_norsca_2wh_main_sc_nor_albion	Occupied Miragliano (Village)	true
building_culture_variants_name_wh2_main_special_settlement_miragliano_norsca_3wh_main_sc_nor_albion	Occupied Miragliano (Town)	true
building_culture_variants_name_wh2_main_special_settlement_miragliano_norsca_4wh_main_sc_nor_albion	Occupied Miragliano (City)	true
building_culture_variants_name_wh2_main_special_settlement_miragliano_norsca_5wh_main_sc_nor_albion	Occupied Miragliano (City-State)	true
building_culture_variants_name_wh2_main_foreign_slot_discovery_nor_1wh_main_sc_nor_albion	Tribal Patrols	true
building_culture_variants_name_wh_main_nor_erengrad_uniquewh_main_sc_nor_albion	Cave of the Rocky Throne	true
building_culture_variants_name_wh2_main_special_settlement_kislev_norsca_1wh_main_sc_nor_albion	Occupied Kislev (Hamlet)	true
building_culture_variants_name_wh2_main_special_settlement_kislev_norsca_2wh_main_sc_nor_albion	Occupied Kislev (Village)	true
building_culture_variants_name_wh2_main_special_settlement_kislev_norsca_3wh_main_sc_nor_albion	Occupied Kislev (Town)	true
building_culture_variants_name_wh2_main_special_settlement_kislev_norsca_4wh_main_sc_nor_albion	Occupied Kislev (City)	true
building_culture_variants_name_wh2_main_special_settlement_kislev_norsca_5wh_main_sc_nor_albion	Occupied Kislev (City-State)	true
building_culture_variants_name_wh2_main_special_settlement_lahmia_norsca_1wh_main_sc_nor_albion	Occupied Lahmia (Warrior Gathering)	true
building_culture_variants_name_wh2_main_special_settlement_lahmia_norsca_2wh_main_sc_nor_albion	Occupied Lahmia (Warband Camp)	true
building_culture_variants_name_wh2_main_special_settlement_lahmia_norsca_3wh_main_sc_nor_albion	Occupied Lahmia (Clan Enclave)	true
building_culture_variants_name_wh2_main_special_settlement_lahmia_norsca_4wh_main_sc_nor_albion	Occupied Lahmia (Tribal Stronghold)	true
building_culture_variants_name_wh2_main_special_settlement_lahmia_norsca_5wh_main_sc_nor_albion	Occupied Lahmia (Greater Tribal Stronghold)	true
building_culture_variants_name_wh2_main_special_settlement_khemri_norsca_1wh_main_sc_nor_albion	Occupied Khemri (Warrior Gathering)	true
building_culture_variants_name_wh2_main_special_settlement_khemri_norsca_2wh_main_sc_nor_albion	Occupied Khemri (Warband Camp)	true
building_culture_variants_name_wh2_main_special_settlement_khemri_norsca_3wh_main_sc_nor_albion	Occupied Khemri (Clan Enclave)	true
building_culture_variants_name_wh2_main_special_settlement_khemri_norsca_4wh_main_sc_nor_albion	Occupied Khemri (Tribal Stronghold)	true
building_culture_variants_name_wh2_main_special_settlement_khemri_norsca_5wh_main_sc_nor_albion	Occupied Khemri (Greater Tribal Stronghold)	true
building_culture_variants_name_wh_dlc08_nor_resource_marble_1wh_main_sc_nor_albion	Marble Quarry	true
building_culture_variants_name_wh_dlc08_special_bordeleaux_port_norsca_1wh_main_sc_nor_albion	Bordeleaux Port	true
building_culture_variants_name_wh_dlc08_special_erengrad_port_norsca_1wh_main_sc_nor_albion	Erengrad Docks	true
building_culture_variants_name_wh_dlc08_special_marienburg_port_norsca_1wh_main_sc_nor_albion	Marienburg Docks	true
building_culture_variants_name_wh_main_special_settlement_black_crag_5_norscawh_main_sc_nor_albion	Occupied Black Crag/Karak Drazh (Great Hold)	true
building_culture_variants_name_wh_main_special_settlement_black_crag_4_norscawh_main_sc_nor_albion	Occupied Black Crag/Karak Drazh (Dwarfhold)	true
building_culture_variants_name_wh2_main_special_settlement_altdorf_norsca_1wh_main_sc_nor_albion	Occupied Altdorf (Hamlet)	true
building_culture_variants_name_wh2_main_special_settlement_altdorf_norsca_2wh_main_sc_nor_albion	Occupied Altdorf (Village)	true
building_culture_variants_name_wh2_main_special_settlement_altdorf_norsca_3wh_main_sc_nor_albion	Occupied Altdorf (Town)	true
building_culture_variants_name_wh2_main_special_settlement_altdorf_norsca_4wh_main_sc_nor_albion	Occupied Altdorf (City)	true
building_culture_variants_name_wh2_main_special_settlement_altdorf_norsca_5wh_main_sc_nor_albion	Occupied Altdorf (City-State)	true
building_culture_variants_name_wh_main_special_settlement_black_crag_3_norscawh_main_sc_nor_albion	Occupied Black Crag/Karak Drazh (Dwarf Keep)	true
building_culture_variants_name_wh2_main_special_settlement_hexoatl_norsca_1wh_main_sc_nor_albion	Occupied Hexoatl (Warrior Gathering)	true
building_culture_variants_name_wh2_main_special_settlement_hexoatl_norsca_2wh_main_sc_nor_albion	Occupied Hexoatl (Warband Camp)	true
building_culture_variants_name_wh2_main_special_settlement_hexoatl_norsca_3wh_main_sc_nor_albion	Occupied Hexoatl (Clan Enclave)	true
building_culture_variants_name_wh2_main_special_settlement_hexoatl_norsca_4wh_main_sc_nor_albion	Occupied Hexoatl (Tribal Stronghold)	true
building_culture_variants_name_wh2_main_special_settlement_hexoatl_norsca_5wh_main_sc_nor_albion	Occupied Hexoatl (Greater Tribal Stronghold)	true
building_culture_variants_name_wh2_main_special_settlement_lothern_norsca_1wh_main_sc_nor_albion	Occupied Lothern (Warrior Gathering)	true
building_culture_variants_name_wh2_main_special_settlement_lothern_norsca_2wh_main_sc_nor_albion	Occupied Lothern (Warband Camp)	true
building_culture_variants_name_wh2_main_special_settlement_lothern_norsca_3wh_main_sc_nor_albion	Occupied Lothern (Clan Enclave)	true
building_culture_variants_name_wh2_main_special_settlement_lothern_norsca_4wh_main_sc_nor_albion	Occupied Lothern (Tribal Stronghold)	true
building_culture_variants_name_wh2_main_special_settlement_lothern_norsca_5wh_main_sc_nor_albion	Occupied Lothern (Greater Tribal Stronghold)	true
building_culture_variants_name_wh_main_special_settlement_black_crag_2_norscawh_main_sc_nor_albion	Occupied Black Crag/Karak Drazh (Outpost)	true
building_culture_variants_name_wh2_main_special_settlement_skavenblight_norsca_1wh_main_sc_nor_albion	Occupied Skavenblight (Warrior Gathering)	true
building_culture_variants_name_wh2_main_special_settlement_skavenblight_norsca_2wh_main_sc_nor_albion	Occupied Skavenblight (Warband Camp)	true
building_culture_variants_name_wh2_main_special_settlement_skavenblight_norsca_3wh_main_sc_nor_albion	Occupied Skavenblight (Clan Enclave)	true
building_culture_variants_name_wh2_main_special_settlement_skavenblight_norsca_4wh_main_sc_nor_albion	Occupied Skavenblight (Tribal Stronghold)	true
building_culture_variants_name_wh2_main_special_settlement_skavenblight_norsca_5wh_main_sc_nor_albion	Occupied Skavenblight (Greater Tribal Stronghold)	true
building_culture_variants_name_wh_main_special_settlement_black_crag_1_norscawh_main_sc_nor_albion	Occupied Black Crag/Karak Drazh (Mining Settlement)	true
building_culture_variants_name_wh_main_special_settlement_eight_peaks_4_norscawh_main_sc_nor_albion	Occupied Karak Eight Peaks (Dwarfhold)	true
building_culture_variants_name_wh_main_special_settlement_eight_peaks_5_norscawh_main_sc_nor_albion	Occupied Karak Eight Peaks (Great Hold)	true
building_culture_variants_name_wh_main_special_settlement_eight_peaks_2_norscawh_main_sc_nor_albion	Occupied Karak Eight Peaks (Outpost)	true
building_culture_variants_name_wh_main_special_settlement_eight_peaks_3_norscawh_main_sc_nor_albion	Occupied Karak Eight Peaks (Dwarf Keep)	true
building_culture_variants_name_wh_main_special_settlement_eight_peaks_1_norscawh_main_sc_nor_albion	Occupied Karak Eight Peaks (Mining Settlement)	true
building_culture_variants_name_wh2_main_special_lothern_port_norsca_1wh_main_sc_nor_albion	Lothern Port	true
building_culture_variants_name_wh2_main_special_settlement_naggarond_norsca_1wh_main_sc_nor_albion	Occupied Naggarond (Warrior Gathering)	true
building_culture_variants_name_wh2_main_special_settlement_naggarond_norsca_2wh_main_sc_nor_albion	Occupied Naggarond (Warband Camp)	true
building_culture_variants_name_wh2_main_special_settlement_naggarond_norsca_3wh_main_sc_nor_albion	Occupied Naggarond (Clan Enclave)	true
building_culture_variants_name_wh2_main_special_settlement_naggarond_norsca_4wh_main_sc_nor_albion	Occupied Naggarond (Tribal Stronghold)	true
building_culture_variants_name_wh2_main_special_settlement_naggarond_norsca_5wh_main_sc_nor_albion	Occupied Naggarond (Greater Tribal Stronghold)	true
building_culture_variants_name_wh2_main_special_settlement_sartosa_norsca_1wh_main_sc_nor_albion	Occupied Sartosa Level 1	true
building_culture_variants_name_wh2_main_special_settlement_sartosa_norsca_2wh_main_sc_nor_albion	Occupied Sartosa Level 2	true
building_culture_variants_name_wh2_main_special_settlement_sartosa_norsca_3wh_main_sc_nor_albion	Occupied Sartosa Level 3	true
building_culture_variants_name_wh2_main_special_settlement_sartosa_norsca_4wh_main_sc_nor_albion	Occupied Sartosa Level 4	true
building_culture_variants_name_wh2_main_special_settlement_sartosa_norsca_5wh_main_sc_nor_albion	Occupied Sartosa Level 5	true
building_culture_variants_name_wh2_main_special_settlement_itza_norsca_1wh_main_sc_nor_albion	Occupied Itza (Warrior Gathering)	true
building_culture_variants_name_wh2_main_special_settlement_itza_norsca_2wh_main_sc_nor_albion	Occupied Itza (Warband Camp)	true
building_culture_variants_name_wh2_main_special_settlement_itza_norsca_3wh_main_sc_nor_albion	Occupied Itza (Clan Enclave)	true
building_culture_variants_name_wh2_main_special_settlement_itza_norsca_4wh_main_sc_nor_albion	Occupied Itza (Tribal Stronghold)	true
building_culture_variants_name_wh2_main_special_settlement_itza_norsca_5wh_main_sc_nor_albion	Occupied Itza (Greater Tribal Stronghold)	true
building_culture_variants_name_wh2_main_special_settlement_hellpit_norsca_1wh_main_sc_nor_albion	Occupied Hellpit (Warrior Gathering)	true
building_culture_variants_name_wh2_main_special_settlement_hellpit_norsca_2wh_main_sc_nor_albion	Occupied Hellpit (Warband Camp)	true
building_culture_variants_name_wh2_main_special_settlement_hellpit_norsca_3wh_main_sc_nor_albion	Occupied Hellpit (Clan Enclave)	true
building_culture_variants_name_wh2_main_special_settlement_hellpit_norsca_4wh_main_sc_nor_albion	Occupied Hellpit (Tribal Stronghold)	true
building_culture_variants_name_wh2_main_special_settlement_hellpit_norsca_5wh_main_sc_nor_albion	Occupied Hellpit (Greater Tribal Stronghold)	true
building_culture_variants_name_wh_dlc08_nor_resource_iron_1wh_main_sc_nor_albion	Iron Mine	true
building_culture_variants_name_ovn_cd_slave_1wh2_main_nor_rotbloods	Slave Pen	true
building_culture_variants_name_ovn_cd_slave_2wh2_main_nor_rotbloods	Slave Market	true
building_culture_variants_name_ovn_cd_work_1wh2_main_nor_rotbloods	Workshop	true
building_culture_variants_name_ovn_cd_work_2wh2_main_nor_rotbloods	Workshop	true
building_culture_variants_name_ovn_cd_work_3wh2_main_nor_rotbloods	Hell Workshop	true
building_culture_variants_name_ovn_Clan_Fester_1wh2_main_nor_rotbloods	Clan Fester Burrow	false
building_culture_variants_name_ovn_Clan_Fester_2wh2_main_nor_rotbloods	Clan Fester Nest	false
building_culture_variants_name_ovn_Clan_Fester_3wh2_main_nor_rotbloods	Clan Fester Hive	false
building_culture_variants_name_wh_main_nor_outpost_minor_human_3wh2_main_nor_rotbloods	Chaos Stronghold	false
building_culture_variants_name_wh_main_nor_outpost_minor_human_2wh2_main_nor_rotbloods	Chaos Keep	false
building_culture_variants_name_wh_main_nor_outpost_minor_human_1wh2_main_nor_rotbloods	Cult Hideout	false
building_culture_variants_name_wh_main_nor_outpost_major_human_3wh2_main_nor_rotbloods	Chaos Stronghold	false
building_culture_variants_name_wh_main_nor_outpost_major_human_2wh2_main_nor_rotbloods	Chaos Keep	false
building_culture_variants_name_wh_main_nor_outpost_major_human_1wh2_main_nor_rotbloods	Cult Hideout	false
building_culture_variants_name_wh_main_nor_outpost_minor_human_1_coastwh2_main_nor_rotbloods	Cult Hideout	false
building_culture_variants_name_wh_main_nor_outpost_minor_human_2_coastwh2_main_nor_rotbloods	Chaos Keep	false
building_culture_variants_name_wh_main_nor_outpost_minor_human_3_coastwh2_main_nor_rotbloods	Chaos Stronghold	false
building_culture_variants_name_wh_main_nor_outpost_major_human_1_coastwh2_main_nor_rotbloods	Cult Hideout	false
building_culture_variants_name_wh_main_nor_outpost_major_human_2_coastwh2_main_nor_rotbloods	Chaos Keep	false
building_culture_variants_name_wh_main_nor_outpost_major_human_3_coastwh2_main_nor_rotbloods	Chaos Stronghold	false
building_culture_variants_name_wh_main_nor_outpost_military_1wh2_main_nor_rotbloods	Lesser Chaos Rift	false
building_culture_variants_name_wh_main_nor_outpost_military_2wh2_main_nor_rotbloods	Chaos Rift	false
building_culture_variants_name_wh_main_nor_outpost_military_3wh2_main_nor_rotbloods	Greater Chaos Rift	false
building_culture_variants_name_wh_main_nor_outpost_garrison_1wh2_main_nor_rotbloods	Dreadpost	false
building_culture_variants_name_wh_main_nor_outpost_garrison_2wh2_main_nor_rotbloods	Dread Tower	false
building_culture_variants_name_wh_main_nor_outpost_garrison_3wh2_main_nor_rotbloods	Chaos Dreadhold	false
building_culture_variants_name_wh_main_nor_worship_1wh2_main_nor_rotbloods	Bubonic Altar	false
building_culture_variants_name_wh_main_nor_outpost_growth_1wh2_main_nor_rotbloods	Bubonic Altar	false
building_culture_variants_name_wh_main_nor_outpost_growth_2wh2_main_nor_rotbloods	Dread Altar	false
building_culture_variants_name_wh_main_nor_outpost_growth_3wh2_main_nor_rotbloods	Forsaken Altar	false
building_culture_variants_name_wh_main_nor_outpost_income_1wh2_main_nor_rotbloods	Treasure Trove	false
building_culture_variants_name_wh_main_nor_outpost_income_2wh2_main_nor_rotbloods	Plunder Hall	false
building_culture_variants_name_wh_main_nor_outpost_income_3wh2_main_nor_rotbloods	Dungeon of Forgotten Riches	false
building_culture_variants_name_wh_main_nor_outpost_stables_1wh2_main_nor_rotbloods	Mound of Maggots	false
building_culture_variants_name_wh_main_nor_outpost_stables_2wh2_main_nor_rotbloods	Altar of Filth	false
building_culture_variants_name_wh_main_nor_outpost_stables_3wh2_main_nor_rotbloods	Rot Stone	false
building_culture_variants_name_ovn_warp_military_1wh2_main_nor_rotbloods	Lesser Chaos Rift	true
building_culture_variants_name_ovn_warp_military_2wh2_main_nor_rotbloods	Chaos Rift	true
building_culture_variants_name_ovn_warp_military_3wh2_main_nor_rotbloods	Greater Chaos Rift	true
building_culture_variants_name_ovn_warp_military_4wh2_main_nor_rotbloods	Eternal Chaos Rift	true
building_culture_variants_name_ovn_warp_stables_1wh2_main_nor_rotbloods	Mound of Maggots	true
building_culture_variants_name_ovn_warp_stables_2wh2_main_nor_rotbloods	Altar of Filth	true
building_culture_variants_name_ovn_warp_stables_3wh2_main_nor_rotbloods	Rot Stone	true
building_culture_variants_name_ovn_warp_stables_4wh2_main_nor_rotbloods	Rot Shrine	true
building_culture_variants_name_ovn_chs_agentwh2_main_nor_rotbloods	Corrupted Shrine of Heroes	true
building_culture_variants_name_ovn_evil_income_3wh2_main_nor_rotbloods	Slave Mining Labyrinth	true
building_culture_variants_name_ovn_evil_income_2wh2_main_nor_rotbloods	Slave Mining Shaft	true
building_culture_variants_name_ovn_evil_income_1wh2_main_nor_rotbloods	Slave Mining Pit	true
building_culture_variants_name_ovn_nor_outpost_major_human_4wh2_main_nor_rotbloods	Dread Fort	true
building_culture_variants_name_wh_main_nor_outpost_military_4wh2_main_nor_rotbloods	Eternal Chaos Rift	true
building_culture_variants_name_wh_main_nor_outpost_garrison_4wh2_main_nor_rotbloods	Chaos Bastion 	true
building_culture_variants_name_wh_main_nor_outpost_stables_4wh2_main_nor_rotbloods	Altar of Bones	true
building_culture_variants_name_wh_main_nor_outpost_major_human_4_coastwh2_main_nor_rotbloods	Dread Fort	true
building_culture_variants_name_ovn_warp_skaven_mercswh2_main_nor_rotbloods	Warpstone Storage	true
building_culture_variants_name_ovn_rot_stables_1wh2_main_nor_rotbloods	Mound of Maggots	true
building_culture_variants_name_ovn_rot_stables_2wh2_main_nor_rotbloods	Altar of Filth	true
building_culture_variants_name_ovn_rot_stables_3wh2_main_nor_rotbloods	Rot Stone	true
building_culture_variants_name_ovn_rot_stables_4wh2_main_nor_rotbloods	Rot Shrine	true
building_culture_variants_name_ovn_rot_stables_5wh2_main_nor_rotbloods	Monolith of Rebirth	true
building_culture_variants_name_ovn_rot_military_1wh2_main_nor_rotbloods	Dimensional Tear	true
building_culture_variants_name_ovn_rot_military_2wh2_main_nor_rotbloods	Lesser Chaos Rift	true
building_culture_variants_name_ovn_rot_military_3wh2_main_nor_rotbloods	Greater Chaos Rift	true
building_culture_variants_name_ovn_rot_military_4wh2_main_nor_rotbloods	Chaos Portal Rupture	true
building_culture_variants_name_ovn_rot_military_5wh2_main_nor_rotbloods	Eternal Chaos Portal Rupture	true
building_culture_variants_name_ovn_rot_monsters_1wh2_main_nor_rotbloods	Warhound Kennels	true
building_culture_variants_name_ovn_rot_monsters_2wh2_main_nor_rotbloods	Fog-Shrouded Fens	true
building_culture_variants_name_ovn_rot_monsters_3wh2_main_nor_rotbloods	Ice Troll Lair	true
building_culture_variants_name_ovn_rot_monsters_4wh2_main_nor_rotbloods	Glacial Passages	true
building_chains_chain_tooltip_ovn_rot_stables	Stables	false
building_chains_chain_tooltip_ovn_rot_military	Chaos Portal	false
building_chains_chain_tooltip_ovn_rot_monsters	Creatures of Chaos	false
building_chains_chain_tooltip_ovn_warp_skaven_mercs	Skaven Mercenaries	false
building_culture_variants_name_ovn_warp_skaven_mercs_2wh2_main_nor_rotbloods	Warpstone Storage	true
building_culture_variants_name_ovn_warp_skaven_mercs_3wh2_main_nor_rotbloods	Warpstone Storage	true
building_culture_variants_name_ovn_warp_skaven_mercs_4wh2_main_nor_rotbloods	Warpstone Storage	true
building_culture_variants_name_ovn_warp_skaven_mercs_5wh2_main_nor_rotbloods	Warpstone Storage	true
building_culture_variants_name_ovn_troll_Bridgeswh2_main_nor_trollz	Crossings	true
building_chains_chain_tooltip_ovn_troll_Bridges	Income	false
building_culture_variants_name_ovn_troll_Wyvernwh2_main_nor_trollz	Giant's Pit	true
building_chains_chain_tooltip_ovn_troll_Wyvern	Monsters	false
building_short_description_texts_short_description_ovn_troll_Wyvern	Giant Trolls are usually avoided by their smaller kin and have plenty of room for themselves. The messy leftovers of their meals often attract feral Wyverns which sometimes will follow the trolls around in the hope of more easy prey.	false
building_culture_variants_name_ovn_troll_creatures_1wh2_main_nor_trollz	Brawling Den	true
building_culture_variants_name_ovn_troll_creatures_2wh2_main_nor_trollz	Fighting Pit	true
building_culture_variants_name_ovn_troll_offerings_1wh2_main_nor_trollz	Offering of Bone & Limb	true
building_culture_variants_name_ovn_troll_outpost_stables_1wh2_main_nor_trollz	Fighting Cage	true
building_culture_variants_name_ovn_troll_outpost_stables_2wh2_main_nor_trollz	Brawling Den	true
building_culture_variants_name_ovn_troll_outpost_stables_3wh2_main_nor_trollz	Fighting Pit	true
building_culture_variants_name_ovn_troll_worship_1wh2_main_nor_trollz	Dung Idol	true
building_culture_variants_name_arb_fatandira_landmarkwh2_main_arb_aswad_scythans	Tomb of the Death Scarab	true
building_culture_variants_name_arb_flaming_scimitar_main_1wh_main_sc_emp_araby	General Cabin	true
building_culture_variants_name_arb_flaming_scimitar_main_2wh_main_sc_emp_araby	Officers' Cabin	true
building_culture_variants_name_arb_flaming_scimitar_main_3wh_main_sc_emp_araby	Captain's Cabin	true
building_culture_variants_name_arb_flaming_scimitar_main_4wh_main_sc_emp_araby	Sea Cabin	true
building_culture_variants_name_arb_flaming_scimitar_main_5wh_main_sc_emp_araby	Great Cabin	true
building_culture_variants_name_arb_flaming_scimitar_barracks_1wh_main_sc_emp_araby	Spar Deck	true
building_culture_variants_name_arb_flaming_scimitar_barracks_2wh_main_sc_emp_araby	Upper Deck	true
building_culture_variants_name_arb_flaming_scimitar_barracks_3wh_main_sc_emp_araby	Weather Deck	true
building_culture_variants_name_arb_flaming_scimitar_support_monsters_1wh_main_sc_emp_araby	Basic Wooden Hull	true
building_culture_variants_name_arb_flaming_scimitar_support_monsters_2wh_main_sc_emp_araby	Wooden Hull with Keel	true
building_culture_variants_name_arb_flaming_scimitar_support_monsters_3wh_main_sc_emp_araby	Composite Hull	true
building_culture_variants_name_arb_flaming_scimitar_support_mages_1wh_main_sc_emp_araby	Magician's Minbar	true
building_culture_variants_name_arb_flaming_scimitar_support_mages_2wh_main_sc_emp_araby	Magician's Dome	true
building_culture_variants_name_arb_flaming_scimitar_structure_movement_1wh_main_sc_emp_araby	Topgallant Royal	true
building_culture_variants_name_arb_flaming_scimitar_structure_movement_2wh_main_sc_emp_araby	Skysail	true
building_culture_variants_name_arb_flaming_scimitar_structure_movement_3wh_main_sc_emp_araby	Moonraker	true
building_culture_variants_name_arb_flaming_scimitar_structure_upkeep_1wh_main_sc_emp_araby	Tiller	true
building_culture_variants_name_arb_flaming_scimitar_structure_upkeep_2wh_main_sc_emp_araby	Whipstaff	true
building_culture_variants_name_arb_flaming_scimitar_structure_upkeep_3wh_main_sc_emp_araby	Ship's Wheel	true
building_culture_variants_name_arb_flaming_scimitar_structure_replenishment_1wh_main_sc_emp_araby	Ship's Hold	true
building_culture_variants_name_arb_flaming_scimitar_structure_replenishment_2wh_main_sc_emp_araby	Cargo Hold	true
building_culture_variants_name_arb_flaming_scimitar_structure_replenishment_3wh_main_sc_emp_araby	Bulk Cargo Hold	true
building_culture_variants_name_arb_flaming_scimitar_structure_growth_1wh_main_sc_emp_araby	Heavy Ballast	true
building_culture_variants_name_arb_flaming_scimitar_structure_growth_2wh_main_sc_emp_araby	Stone Weight	true
building_culture_variants_name_arb_flaming_scimitar_structure_growth_3wh_main_sc_emp_araby	Steel Anchor	true
building_culture_variants_name_arb_flaming_scimitar_defense_bombardment_1wh_main_sc_emp_araby	Bronze Cannons	true
building_culture_variants_name_arb_flaming_scimitar_defense_bombardment_2wh_main_sc_emp_araby	Gunports	true
building_culture_variants_name_arb_flaming_scimitar_defense_bombardment_3wh_main_sc_emp_araby	Bronze Cannons	true
building_culture_variants_name_arb_flaming_scimitar_unique_minaret_1wh_main_sc_emp_araby	Minaret of Flames	true
building_culture_variants_name_arb_flaming_scimitar_defense_magical_bombardment_1wh_main_sc_emp_araby	Magician's Lookout	true
building_culture_variants_name_arb_flaming_scimitar_defense_magical_bombardment_2wh_main_sc_emp_araby	Minaret of Tempests	true
building_culture_variants_name_arb_golden_magus_special_galleon_graveyard_1wh2_main_arb_flaming_scimitar	The Golden Magus' Paradise	true
building_culture_variants_name_arb_golden_magus_special_galleon_graveyard_ruinwh2_main_arb_flaming_scimitar	The Golden Magus' Paradise (Inert)	true
building_culture_variants_name_wh2_main_special_settlement_castle_drakenhof_norsca_1wh_main_chs_chaoswh_main_sc_nor_troll	Occupied Drakenhof (Hamlet)	true
building_culture_variants_name_wh2_main_special_settlement_castle_drakenhof_norsca_2wh_main_chs_chaoswh_main_sc_nor_troll	Occupied Drakenhof (Village)	true
building_culture_variants_name_wh2_main_special_settlement_castle_drakenhof_norsca_3wh_main_chs_chaoswh_main_sc_nor_troll	Occupied Drakenhof (Town)	true
building_culture_variants_name_wh2_main_special_settlement_castle_drakenhof_norsca_4wh_main_chs_chaoswh_main_sc_nor_troll	Occupied Drakenhof (City)	true
building_culture_variants_name_wh2_main_special_settlement_castle_drakenhof_norsca_5wh_main_chs_chaoswh_main_sc_nor_troll	Occupied Drakenhof (City-State)	true
building_culture_variants_name_wh_dlc08_nor_resource_obsidian_1wh_main_chs_chaoswh_main_sc_nor_troll	Obsidian Quarry	true
building_culture_variants_name_wh2_main_special_settlement_couronne_norsca_1wh_main_chs_chaoswh_main_sc_nor_troll	Occupied Couronne (Hamlet)	true
building_culture_variants_name_wh2_main_special_settlement_couronne_norsca_2wh_main_chs_chaoswh_main_sc_nor_troll	Occupied Couronne (Village)	true
building_culture_variants_name_wh2_main_special_settlement_couronne_norsca_3wh_main_chs_chaoswh_main_sc_nor_troll	Occupied Couronne (Town)	true
building_culture_variants_name_wh2_main_special_settlement_couronne_norsca_4wh_main_chs_chaoswh_main_sc_nor_troll	Occupied Couronne (City)	true
building_culture_variants_name_wh2_main_special_settlement_couronne_norsca_5wh_main_chs_chaoswh_main_sc_nor_troll	Occupied Couronne (City-State)	true
building_culture_variants_name_wh2_main_special_settlement_the_awakening_norsca_1wh_main_chs_chaoswh_main_sc_nor_troll	Occupied The Awakening Level 1	true
building_culture_variants_name_wh2_main_special_settlement_the_awakening_norsca_2wh_main_chs_chaoswh_main_sc_nor_troll	Occupied The Awakening Level 2	true
building_culture_variants_name_wh2_main_special_settlement_the_awakening_norsca_3wh_main_chs_chaoswh_main_sc_nor_troll	Occupied The Awakening Level 3	true
building_culture_variants_name_wh2_main_special_settlement_the_awakening_norsca_4wh_main_chs_chaoswh_main_sc_nor_troll	Occupied The Awakening Level 4	true
building_culture_variants_name_wh2_main_special_settlement_the_awakening_norsca_5wh_main_chs_chaoswh_main_sc_nor_troll	Occupied The Awakening Level 5	true
building_culture_variants_name_wh_main_special_settlement_karaz_a_karak_5_norscawh_main_chs_chaoswh_main_sc_nor_troll	Occupied Karaz-a-Karak (Great Hold)	true
building_culture_variants_name_wh_main_special_settlement_karaz_a_karak_4_norscawh_main_chs_chaoswh_main_sc_nor_troll	Occupied Karaz-a-Karak (Dwarfhold)	true
building_culture_variants_name_wh_main_special_settlement_karaz_a_karak_3_norscawh_main_chs_chaoswh_main_sc_nor_troll	Occupied Karaz-a-Karak (Dwarf Keep)	true
building_culture_variants_name_wh_main_special_settlement_karaz_a_karak_2_norscawh_main_chs_chaoswh_main_sc_nor_troll	Occupied Karaz-a-Karak (Outpost)	true
building_culture_variants_name_wh_main_special_settlement_karaz_a_karak_1_norscawh_main_chs_chaoswh_main_sc_nor_troll	Occupied Karaz-a-Karak (Mining Settlement)	true
building_culture_variants_name_wh2_main_special_settlement_gaean_vale_norsca_1wh_main_chs_chaoswh_main_sc_nor_troll	Occupied Gaean Vale (Troll Gathering)	true
building_culture_variants_name_wh2_main_special_settlement_gaean_vale_norsca_2wh_main_chs_chaoswh_main_sc_nor_troll	Occupied Gaean Vale (Troll Camp)	true
building_culture_variants_name_wh2_main_special_settlement_gaean_vale_norsca_3wh_main_chs_chaoswh_main_sc_nor_troll	Occupied Gaean Vale (Troll Enclave)	true
building_culture_variants_name_wh2_main_special_settlement_gaean_vale_norsca_4wh_main_chs_chaoswh_main_sc_nor_troll	Occupied Gaean Vale (Troll Stronghold)	true
building_culture_variants_name_wh2_main_special_settlement_gaean_vale_norsca_5wh_main_chs_chaoswh_main_sc_nor_troll	Occupied Gaean Vale (Greater Troll Stronghold)	true
building_culture_variants_name_wh2_main_special_settlement_miragliano_norsca_1wh_main_chs_chaoswh_main_sc_nor_troll	Occupied Miragliano (Hamlet)	true
building_culture_variants_name_wh2_main_special_settlement_miragliano_norsca_2wh_main_chs_chaoswh_main_sc_nor_troll	Occupied Miragliano (Village)	true
building_culture_variants_name_wh2_main_special_settlement_miragliano_norsca_3wh_main_chs_chaoswh_main_sc_nor_troll	Occupied Miragliano (Town)	true
building_culture_variants_name_wh2_main_special_settlement_miragliano_norsca_4wh_main_chs_chaoswh_main_sc_nor_troll	Occupied Miragliano (City)	true
building_culture_variants_name_wh2_main_special_settlement_miragliano_norsca_5wh_main_chs_chaoswh_main_sc_nor_troll	Occupied Miragliano (City-State)	true
building_culture_variants_name_wh2_main_foreign_slot_discovery_nor_1wh_main_chs_chaoswh_main_sc_nor_troll	Marauder Patrols	true
building_culture_variants_name_wh_main_nor_erengrad_uniquewh_main_chs_chaoswh_main_sc_nor_troll	Cave of the Rocky Throne	true
building_culture_variants_name_wh2_main_special_settlement_kislev_norsca_1wh_main_chs_chaoswh_main_sc_nor_troll	Occupied Kislev (Hamlet)	true
building_culture_variants_name_wh2_main_special_settlement_kislev_norsca_2wh_main_chs_chaoswh_main_sc_nor_troll	Occupied Kislev (Village)	true
building_culture_variants_name_wh2_main_special_settlement_kislev_norsca_3wh_main_chs_chaoswh_main_sc_nor_troll	Occupied Kislev (Town)	true
building_culture_variants_name_wh2_main_special_settlement_kislev_norsca_4wh_main_chs_chaoswh_main_sc_nor_troll	Occupied Kislev (City)	true
building_culture_variants_name_wh2_main_special_settlement_kislev_norsca_5wh_main_chs_chaoswh_main_sc_nor_troll	Occupied Kislev (City-State)	true
building_culture_variants_name_wh2_main_special_settlement_lahmia_norsca_1wh_main_chs_chaoswh_main_sc_nor_troll	Occupied Lahmia (Troll Gathering)	true
building_culture_variants_name_wh2_main_special_settlement_lahmia_norsca_2wh_main_chs_chaoswh_main_sc_nor_troll	Occupied Lahmia (Troll Camp)	true
building_culture_variants_name_wh2_main_special_settlement_lahmia_norsca_3wh_main_chs_chaoswh_main_sc_nor_troll	Occupied Lahmia (Troll Enclave)	true
building_culture_variants_name_wh2_main_special_settlement_lahmia_norsca_4wh_main_chs_chaoswh_main_sc_nor_troll	Occupied Lahmia (Troll Stronghold)	true
building_culture_variants_name_wh2_main_special_settlement_lahmia_norsca_5wh_main_chs_chaoswh_main_sc_nor_troll	Occupied Lahmia (Greater Trolll Stronghold)	true
building_culture_variants_name_wh2_main_special_settlement_khemri_norsca_1wh_main_chs_chaoswh_main_sc_nor_troll	Occupied Khemri (Troll Gathering)	true
building_culture_variants_name_wh2_main_special_settlement_khemri_norsca_2wh_main_chs_chaoswh_main_sc_nor_troll	Occupied Khemri (Troll Camp)	true
building_culture_variants_name_wh2_main_special_settlement_khemri_norsca_3wh_main_chs_chaoswh_main_sc_nor_troll	Occupied Khemri (Troll Enclave)	true
building_culture_variants_name_wh2_main_special_settlement_khemri_norsca_4wh_main_chs_chaoswh_main_sc_nor_troll	Occupied Khemri (Troll Stronghold)	true
building_culture_variants_name_wh2_main_special_settlement_khemri_norsca_5wh_main_chs_chaoswh_main_sc_nor_troll	Occupied Khemri (Greater Troll Stronghold)	true
building_culture_variants_name_wh_dlc08_nor_resource_marble_1wh_main_chs_chaoswh_main_sc_nor_troll	Marble Quarry	true
building_culture_variants_name_wh_dlc08_special_bordeleaux_port_norsca_1wh_main_chs_chaoswh_main_sc_nor_troll	Bordeleaux Port	true
building_culture_variants_name_wh_dlc08_special_erengrad_port_norsca_1wh_main_chs_chaoswh_main_sc_nor_troll	Erengrad Docks	true
building_culture_variants_name_wh_dlc08_special_marienburg_port_norsca_1wh_main_chs_chaoswh_main_sc_nor_troll	Marienburg Docks	true
building_culture_variants_name_wh_main_special_settlement_black_crag_5_norscawh_main_chs_chaoswh_main_sc_nor_troll	Occupied Black Crag/Karak Drazh (Great Hold)	true
building_culture_variants_name_wh_main_special_settlement_black_crag_4_norscawh_main_chs_chaoswh_main_sc_nor_troll	Occupied Black Crag/Karak Drazh (Dwarfhold)	true
building_culture_variants_name_wh2_main_special_settlement_altdorf_norsca_1wh_main_chs_chaoswh_main_sc_nor_troll	Occupied Altdorf (Hamlet)	true
building_culture_variants_name_wh2_main_special_settlement_altdorf_norsca_2wh_main_chs_chaoswh_main_sc_nor_troll	Occupied Altdorf (Village)	true
building_culture_variants_name_wh2_main_special_settlement_altdorf_norsca_3wh_main_chs_chaoswh_main_sc_nor_troll	Occupied Altdorf (Town)	true
building_culture_variants_name_wh2_main_special_settlement_altdorf_norsca_4wh_main_chs_chaoswh_main_sc_nor_troll	Occupied Altdorf (City)	true
building_culture_variants_name_wh2_main_special_settlement_altdorf_norsca_5wh_main_chs_chaoswh_main_sc_nor_troll	Occupied Altdorf (City-State)	true
building_culture_variants_name_wh_main_special_settlement_black_crag_3_norscawh_main_chs_chaoswh_main_sc_nor_troll	Occupied Black Crag/Karak Drazh (Dwarf Keep)	true
building_culture_variants_name_wh2_main_special_settlement_hexoatl_norsca_1wh_main_chs_chaoswh_main_sc_nor_troll	Occupied Hexoatl (Troll Gathering)	true
building_culture_variants_name_wh2_main_special_settlement_hexoatl_norsca_2wh_main_chs_chaoswh_main_sc_nor_troll	Occupied Hexoatl (Troll Camp)	true
building_culture_variants_name_wh2_main_special_settlement_hexoatl_norsca_3wh_main_chs_chaoswh_main_sc_nor_troll	Occupied Hexoatl (Troll Enclave)	true
building_culture_variants_name_wh2_main_special_settlement_hexoatl_norsca_4wh_main_chs_chaoswh_main_sc_nor_troll	Occupied Hexoatl (Troll Stronghold)	true
building_culture_variants_name_wh2_main_special_settlement_hexoatl_norsca_5wh_main_chs_chaoswh_main_sc_nor_troll	Occupied Hexoatl (Greater Troll Stronghold)	true
building_culture_variants_name_wh2_main_special_settlement_lothern_norsca_1wh_main_chs_chaoswh_main_sc_nor_troll	Occupied Lothern (Troll Gathering)	true
building_culture_variants_name_wh2_main_special_settlement_lothern_norsca_2wh_main_chs_chaoswh_main_sc_nor_troll	Occupied Lothern (Troll Camp)	true
building_culture_variants_name_wh2_main_special_settlement_lothern_norsca_3wh_main_chs_chaoswh_main_sc_nor_troll	Occupied Lothern (Troll Enclave)	true
building_culture_variants_name_wh2_main_special_settlement_lothern_norsca_4wh_main_chs_chaoswh_main_sc_nor_troll	Occupied Lothern (Troll Stronghold)	true
building_culture_variants_name_wh2_main_special_settlement_lothern_norsca_5wh_main_chs_chaoswh_main_sc_nor_troll	Occupied Lothern (Greater Troll Stronghold)	true
building_culture_variants_name_wh_main_special_settlement_black_crag_2_norscawh_main_chs_chaoswh_main_sc_nor_troll	Occupied Black Crag/Karak Drazh (Troll Sty)	true
building_culture_variants_name_wh2_main_special_settlement_skavenblight_norsca_1wh_main_chs_chaoswh_main_sc_nor_troll	Occupied Skavenblight (Troll Gathering)	true
building_culture_variants_name_wh2_main_special_settlement_skavenblight_norsca_2wh_main_chs_chaoswh_main_sc_nor_troll	Occupied Skavenblight (Troll Camp)	true
building_culture_variants_name_wh2_main_special_settlement_skavenblight_norsca_3wh_main_chs_chaoswh_main_sc_nor_troll	Occupied Skavenblight (Troll Enclave)	true
building_culture_variants_name_wh2_main_special_settlement_skavenblight_norsca_4wh_main_chs_chaoswh_main_sc_nor_troll	Occupied Skavenblight (Troll Stronghold)	true
building_culture_variants_name_wh2_main_special_settlement_skavenblight_norsca_5wh_main_chs_chaoswh_main_sc_nor_troll	Occupied Skavenblight (Greater Troll Stronghold)	true
building_culture_variants_name_wh_main_special_settlement_black_crag_1_norscawh_main_chs_chaoswh_main_sc_nor_troll	Occupied Black Crag/Karak Drazh (Mining Settlement)	true
building_culture_variants_name_wh_main_special_settlement_eight_peaks_4_norscawh_main_chs_chaoswh_main_sc_nor_troll	Occupied Karak Eight Peaks (Dwarfhold)	true
building_culture_variants_name_wh_main_special_settlement_eight_peaks_5_norscawh_main_chs_chaoswh_main_sc_nor_troll	Occupied Karak Eight Peaks (Great Hold)	true
building_culture_variants_name_wh_main_special_settlement_eight_peaks_2_norscawh_main_chs_chaoswh_main_sc_nor_troll	Occupied Karak Eight Peaks (Outpost)	true
building_culture_variants_name_wh_main_special_settlement_eight_peaks_3_norscawh_main_chs_chaoswh_main_sc_nor_troll	Occupied Karak Eight Peaks (Dwarf Keep)	true
building_culture_variants_name_wh_main_special_settlement_eight_peaks_1_norscawh_main_chs_chaoswh_main_sc_nor_troll	Occupied Karak Eight Peaks (Mining Settlement)	true
building_culture_variants_name_wh2_main_special_lothern_port_norsca_1wh_main_chs_chaoswh_main_sc_nor_troll	Lothern Port	true
building_culture_variants_name_wh2_main_special_settlement_naggarond_norsca_1wh_main_chs_chaoswh_main_sc_nor_troll	Occupied Naggarond (Troll Gathering)	true
building_culture_variants_name_wh2_main_special_settlement_naggarond_norsca_2wh_main_chs_chaoswh_main_sc_nor_troll	Occupied Naggarond (Troll Camp)	true
building_culture_variants_name_wh2_main_special_settlement_naggarond_norsca_3wh_main_chs_chaoswh_main_sc_nor_troll	Occupied Naggarond (Troll Enclave)	true
building_culture_variants_name_wh2_main_special_settlement_naggarond_norsca_4wh_main_chs_chaoswh_main_sc_nor_troll	Occupied Naggarond (Troll Stronghold)	true
building_culture_variants_name_wh2_main_special_settlement_naggarond_norsca_5wh_main_chs_chaoswh_main_sc_nor_troll	Occupied Naggarond (Greater Troll Stronghold)	true
building_culture_variants_name_wh2_main_special_settlement_sartosa_norsca_1wh_main_chs_chaoswh_main_sc_nor_troll	Occupied Sartosa Level 1	true
building_culture_variants_name_wh2_main_special_settlement_sartosa_norsca_2wh_main_chs_chaoswh_main_sc_nor_troll	Occupied Sartosa Level 2	true
building_culture_variants_name_wh2_main_special_settlement_sartosa_norsca_3wh_main_chs_chaoswh_main_sc_nor_troll	Occupied Sartosa Level 3	true
building_culture_variants_name_wh2_main_special_settlement_sartosa_norsca_4wh_main_chs_chaoswh_main_sc_nor_troll	Occupied Sartosa Level 4	true
building_culture_variants_name_wh2_main_special_settlement_sartosa_norsca_5wh_main_chs_chaoswh_main_sc_nor_troll	Occupied Sartosa Level 5	true
building_culture_variants_name_wh2_main_special_settlement_itza_norsca_1wh_main_chs_chaoswh_main_sc_nor_troll	Occupied Itza (Troll Gathering)	true
building_culture_variants_name_wh2_main_special_settlement_itza_norsca_2wh_main_chs_chaoswh_main_sc_nor_troll	Occupied Itza (Troll Camp)	true
building_culture_variants_name_wh2_main_special_settlement_itza_norsca_3wh_main_chs_chaoswh_main_sc_nor_troll	Occupied Itza (Troll Enclave)	true
building_culture_variants_name_wh2_main_special_settlement_itza_norsca_4wh_main_chs_chaoswh_main_sc_nor_troll	Occupied Itza (Troll Stronghold)	true
building_culture_variants_name_wh2_main_special_settlement_itza_norsca_5wh_main_chs_chaoswh_main_sc_nor_troll	Occupied Itza (Greater Troll Stronghold)	true
building_culture_variants_name_wh2_main_special_settlement_hellpit_norsca_1wh_main_chs_chaoswh_main_sc_nor_troll	Occupied Hellpit (Troll Gathering)	true
building_culture_variants_name_wh2_main_special_settlement_hellpit_norsca_2wh_main_chs_chaoswh_main_sc_nor_troll	Occupied Hellpit (Troll Camp)	true
building_culture_variants_name_wh2_main_special_settlement_hellpit_norsca_3wh_main_chs_chaoswh_main_sc_nor_troll	Occupied Hellpit (Troll Enclave)	true
building_culture_variants_name_wh2_main_special_settlement_hellpit_norsca_4wh_main_chs_chaoswh_main_sc_nor_troll	Occupied Hellpit (Troll Stronghold)	true
building_culture_variants_name_wh2_main_special_settlement_hellpit_norsca_5wh_main_chs_chaoswh_main_sc_nor_troll	Occupied Hellpit (Greater Troll Stronghold)	true
building_culture_variants_name_wh_dlc08_nor_resource_iron_1wh_main_chs_chaoswh_main_sc_nor_troll	Iron Mine	true
building_culture_variants_name_wh2_dlc15_special_settlement_massif_orcal_norsca_1wh_main_sc_nor_troll	Occupied Massif Orcal (Troll Gathering)	false
building_culture_variants_name_wh2_dlc15_special_settlement_massif_orcal_norsca_2wh_main_sc_nor_troll	Occupied Massif Orcal (Troll Camp)	false
building_culture_variants_name_wh2_dlc15_special_settlement_massif_orcal_norsca_3wh_main_sc_nor_troll	Occupied Massif Orcal (Troll Enclave)	false
building_culture_variants_name_wh2_dlc15_special_settlement_massif_orcal_norsca_4wh_main_sc_nor_troll	Occupied Massif Orcal (Troll Stronghold)	false
building_culture_variants_name_wh2_dlc15_special_settlement_massif_orcal_norsca_5wh_main_sc_nor_troll	Occupied Massif Orcal (Greater Troll Stronghold)	false
building_culture_variants_name_wh2_main_special_settlement_konquata_norsca_4wh_main_sc_nor_troll	Occupied Konquata (Troll Stronghold)	true
building_culture_variants_name_wh2_main_special_settlement_konquata_norsca_5wh_main_sc_nor_troll	Occupied Konquata (Greater Troll Stronghold)	true
building_culture_variants_name_wh_twa03_special_albion_port_norsca_1wh_main_sc_nor_troll	Albion Docks	true
building_culture_variants_name_wh2_main_special_settlement_konquata_norsca_3wh_main_sc_nor_troll	Occupied Konquata (Troll Enclave)	true
building_culture_variants_name_wh2_main_special_settlement_konquata_norsca_1wh_main_sc_nor_troll	Occupied Konquata (Troll Gathering)	true
building_culture_variants_name_wh2_main_special_settlement_konquata_norsca_2wh_main_sc_nor_troll	Occupied Konquata (Troll Camp)	true
building_culture_variants_name_ovn_Albion_Barrowswh2_main_nor_albion	Barrows of Albion	true
building_chains_chain_tooltip_ovn_Albion_Barrows	Landmark	true
building_short_description_texts_short_description_ovn_Albion_Barrows	In this unremarkable Isle, a series of great, grassy mounds dot the landscape. Ancient man-made hills, serving as the burial tombs of mighty kings and warriors who will rise uneasily to face intruders.	true
building_chains_chain_tooltip_ovn_Albion_War	Landmark	true
building_short_description_texts_short_description_ovn_Albion_War	Even the tribes of Albion can't resist the Dark Emissaries honeyed words of power and riches that emanate from the black citadel.	true
building_short_description_texts_short_description_ovn_Albion_War_2	The citadel is rebuilt anew, a strange and baroque structure of twisted spires and warped gates, that can darken even the most noble soul.	true
building_culture_variants_name_ovn_Albion_War_1wh2_main_nor_harbingers_of_doom	Unsealed Citadel of Lead	true
building_culture_variants_name_ovn_Albion_War_2wh2_main_nor_harbingers_of_doom	Citadel of Lead Reforged	true
building_culture_variants_name_ovn_Albion_Barrowswh2_main_nor_harbingers_of_doom	Barrows of Albion	true
building_short_description_texts_short_description_rotblood_city_1	They meet in the dead of night, Nurgle cultists and fanatics to make sacrifice and offer their thanks for the Fly Fathers rotten gifts.	true
building_short_description_texts_short_description_rotblood_city_2	Old forts twisted and warped to their new decaying masters designs. Most beings know to stay clear unless they wish to seek out the rot or end up in a cauldron as part of an unholy feast.	true
building_short_description_texts_short_description_rotblood_city_3	A foreboding sight, it resembles little of it's former structure, even to look at it's mad and impossible architecture is to risk insanity.	true
building_short_description_texts_short_description_rotblood_city_4	Lights shine from it's many turrets, a glow that drains life from the landscape instead of illuminating it. Sharpened spikes litter the walls ready to implale any who dare scale it. Flee from this place if you value your soul.	true
