Loc PackedFile	1
key	text	tooltip
ui_unit_bullet_point_enums_onscreen_name_finmor	Band Leaders	true
ui_unit_bullet_point_enums_onscreen_name_belakor_blessed	Blessed by the Dark Prince	true
ui_unit_bullet_point_enums_tooltip_finmor	The Finmor use cruel ways to keep their servants fighting.	true
ui_unit_bullet_point_enums_tooltip_belakor_blessed	The Harbringer has blessed these Fimir warriors.	true
ui_unit_bullet_point_enums_onscreen_name_disturbed	Disturbed Killers	true
ui_unit_bullet_point_enums_tooltip_disturbed	Restless and disturbed bands of Fimir, survivors of destroyed clans, now seeking for an end.	true
ui_unit_bullet_point_enums_onscreen_name_nice_elf	Nice (for an Elf)	true
ui_unit_bullet_point_enums_tooltip_nice_elf	While Elfs are generally not the most friendly inhabitants of the Old World, they can be surprisingly nice when not stroking their large egos.	true
ui_unit_bullet_point_enums_onscreen_name_stinking_drunk	Stinkin Drunk	true
ui_unit_bullet_point_enums_tooltip_stinking_drunk	Argaad iz drunk, but y-yo-you don 'ave an.... zzzzzzzzz... zzzzz...... huh, wah, uhn excuz... zzzz....	true
ui_unit_bullet_point_enums_onscreen_name_soup_cannon	Soup Cannon	true
ui_unit_bullet_point_enums_tooltip_soup_cannon	This unit shoots [[img:ui/battle ui/ability_icons/wh_main_unit_contact_souped.png]][[/img]]soup at enemy units, debuffing their [[img:icon_melee_attack]][[/img]]melee attack and [[img:icon_armour]][[/img]]armour for a long time.	true
ui_unit_bullet_point_enums_onscreen_name_poor_ranged_damage	Poor Ranged Damage	true
ui_unit_bullet_point_enums_tooltip_poor_ranged_damage	This unit's projectile does low[[img:ui/skins/default/icon_stat_ranged_damage.png]][[/img]]damage.	true
ui_unit_bullet_point_enums_onscreen_name_amazon_venom	Envenomed Arrows	true
ui_unit_bullet_point_enums_tooltip_amazon_venom	Amazons coat their arrows in powerful venoms harvested from the exotic serpents found in Lustria; victims struck by such arrows are sent into wild bouts of hysteria.	true
ui_unit_bullet_point_enums_onscreen_name_amazon_mac	Stunning Blows	true
ui_unit_bullet_point_enums_tooltip_amazon_mac	Heavy strikes from these exotic clubs can debilitate and crush the defense of even the most armored of foes.	true
ui_unit_bullet_point_enums_tooltip_demonic_flesh	Bel'akor's body is unnaturally resilient to all kinds of damage. It will be difficult to bring this monster down.	true
ui_unit_bullet_point_enums_onscreen_name_demonic_flesh	Demonic Flesh	true
ui_unit_bullet_point_enums_tooltip_uncontrollable_rage	It takes much of Bel'akor's concentration to suppress the unholy rage boiling within him. If he is pushed too far, he will rampage through the enemies lines with wild abandon.	true
ui_unit_bullet_point_enums_onscreen_name_uncontrollable_rage	Uncontrollable Rage	true
ui_unit_bullet_point_enums_tooltip_unstable_form	The body of a Viridian Lord maintains form by the willpower and faith of the warrior soul inside alone. Once this determination wavers, the body starts to crumble.	true
ui_unit_bullet_point_enums_onscreen_name_unstable_form	Unstable Form	true
ui_unit_bullet_point_enums_tooltip_woad_paint	Woad Paint is made and applied by druids and truthsayers. It binds excess winds of magic and protects the wearer from some of the physical attacks. If an area is saturated with unused magic, the protection provided will be more efficient.	true
ui_unit_bullet_point_enums_onscreen_name_woad_paint	Woad Paint	true
ui_unit_bullet_point_enums_tooltip_disciplined	Having mastered their temper, they no longer suffer from the mood swings so common in the warbands of Albion, allowing them to utilize their war fury without any drawbacks.	true
ui_unit_bullet_point_enums_onscreen_name_disciplined	Disciplined	true
ui_unit_bullet_point_enums_tooltip_devestating_charge	As long as they aren't too injured or weakened, the charge of this unit will be savage, uncompromising and simply devastating.	true
ui_unit_bullet_point_enums_onscreen_name_devestating_charge	Devastating Charge	true
ui_unit_bullet_point_enums_tooltip_incredible_will	Even if the body is broken, Highlanders will attempt to fight on for some seconds, forcing their body to keep on moving by sheer willpower alone.	true
ui_unit_bullet_point_enums_onscreen_name_incredible_will	Unbreakable Will	true
ui_unit_bullet_point_enums_tooltip_something_prove	These warriors have focused on proving their worth on the battlefield. As long as their will is unbroken, they will push themselves beyond their limits.	true
ui_unit_bullet_point_enums_onscreen_name_something_prove	Something to Prove	true
ui_unit_bullet_point_enums_tooltip_servants_lugh	These warriors have dedicated themselves to the Sun God who in turn imbues their weapons with flame and grants protection against fire, or so it is believed by the inhabitants. It may also be connected to a secret rite of initiation, overseen by the Truthsayers.	true
ui_unit_bullet_point_enums_onscreen_name_servants_lugh	Servants of the Sun God	true
ui_unit_bullet_point_enums_onscreen_name_embalmed_bodies	Embalmed Bodies	false
ui_unit_bullet_point_enums_tooltip_embalmed_bodies	These Mummies have been embalmed and reinforced with secret ointments and oils, making their bodies highly resistant to damage - but also highly flammable.	false
ui_unit_bullet_point_enums_onscreen_name_slow_but_mighty	Slow but Mighty	false
ui_unit_bullet_point_enums_tooltip_slow_but_mighty	Mummies are no mere zombies, they fight with skill and strength beyond normal humans. However, the way they have been preserved makes them slow on the advance.	false
ui_unit_bullet_point_enums_tooltip_curse_of_the_mummy	The mere touch of a Mummy curses their opponents, sapping their strength and reducing their ability to fight back.	false
ui_unit_bullet_point_enums_onscreen_name_curse_of_the_mummy	Curse of the Mummy	false
ui_unit_bullet_point_enums_tooltip_cant_fight	This unit has no offensive capabilities at all and exists only to support other units. It relies on its allies for protection.	false
ui_unit_bullet_point_enums_onscreen_name_cant_fight	Can't Fight	false
ui_unit_bullet_point_enums_tooltip_support_unit	The main purpose of this unit is to make the units around it better, not to gain kills by itself.	false
ui_unit_bullet_point_enums_onscreen_name_support_unit	Supporter	false
ui_unit_bullet_point_enums_tooltip_bad_air_duelist	This dragon is very young, inexperienced and thrust into war far too early. They are at a disadvantage in air fights against more experienced flyers, even if those creatures look weaker.	false
ui_unit_bullet_point_enums_onscreen_name_bad_air_duelist	Bad Air Duelist	false
ui_unit_bullet_point_enums_tooltip_baby_dragon_breath	Although this dragon is very young, it can still breath flames. They are not as strong or damaging as the flames of a young adult though.	false
ui_unit_bullet_point_enums_onscreen_name_baby_dragon_breath	Hatchling Dragon Breath	false
ui_unit_bullet_point_enums_onscreen_name_whirling_pans	Whirling Pots and Pans	false
ui_unit_bullet_point_enums_tooltip_whirling_pans	While not really shielded, the legendary luck of the halflings causes a surprising amount of projectiles to be deflected by the pans, ladles and similar cooking tools the chefs wield.	false
ui_unit_bullet_point_enums_tooltip_troll_fodder	If Trolls feel down, frightened or have otherwise low morale they will devour this unit to stay in the fight longer.	true
ui_unit_bullet_point_enums_onscreen_name_troll_fodder	Troll Fodder	true
ui_unit_bullet_point_enums_tooltip_mocking_laughter	Night Trolls are known for their mocking laughter while they tear apart their opponents, intimidating their enemies that way.	true
ui_unit_bullet_point_enums_onscreen_name_mocking_laughter	Mocking Laughter	true
ui_unit_bullet_point_enums_onscreen_name_gunther_schepke	Led by Gunther Schepke	true
ui_unit_bullet_point_enums_tooltip_gunther_schepke	These warriors are highly experienced and proficient fighters led by Sergeant Gunther Schepke, Bernhardt's second in command	true
ui_unit_bullet_point_enums_onscreen_name_hellfire_sword	Helfire Sword	false
ui_unit_bullet_point_enums_tooltip_hellfire_sword	This sword is enchanted with the energy of Bright magic.	false
ui_unit_bullet_point_enums_onscreen_name_shield_of_ptolos	Shield of Ptolos	false
ui_unit_bullet_point_enums_tooltip_shield_of_ptolos	The Shield of Ptolos is magically inscribed with a myriad of distracting patterns and designs. The patterns magically distract arrows and bolts, sending them spinning off course. The bearer's regiment will be protected against missiles from bows, crossbows, war engines and so on. 	false
ui_unit_bullet_point_enums_onscreen_name_wolfgang_schwartzkopf	Led by Wolfgang Schwartzkopf 	true
ui_unit_bullet_point_enums_tooltip_wolfgang_schwartzkopf	These artillerists are highly experienced and  led by Wolfgang Schwartzkopf	true
ui_unit_bullet_point_enums_onscreen_name_grudgebringer_sword	Grudgebringer Sword	true
ui_unit_bullet_point_enums_tooltip_grudgebringer_sword	This mighty sword has runes inscribed along the blade by a Bright magic Wizard Lord. In hand-to-hand combat, the wielder strikes more accurately and ferociously against his enemies. Also, a fireball may be cast from the sword once per Magic Cycle.	true
ui_unit_bullet_point_enums_onscreen_name_enchanted_shield	Enchanted Shield	true
ui_unit_bullet_point_enums_tooltip_enchanted_shield	The Enchanted Shield provides the bearer's regiment with an extra level of armour	true
ui_unit_bullet_point_enums_onscreen_name_spelleater_shield	Spelleater Shield	true
ui_unit_bullet_point_enums_tooltip_spelleater_shield	The Spelleater Shield is inscribed with symbols which have the power to absorb enemy magic. Whenever the bearer's regiment is the target of an enemy spell the shield has a good chance of absorbing the magic.	true
ui_unit_bullet_point_enums_onscreen_name_ungrunn_dragonbane_order	Allied regiment	true
ui_unit_bullet_point_enums_tooltip_ungrunn_dragonbane_order	On the orders of King Ungrunn Dragonbane, envoy Engrol Goldtongue with a small army of well-known regiments was sent to help the allied Empire. These dwarfs do not require salaries from Emperor, only a small amount of coins for self-serving food and beer.	true
ui_unit_bullet_point_enums_onscreen_name_deal_with_the_emperor	Arrangement with the Emperor	true
ui_unit_bullet_point_enums_tooltip_deal_with_the_emperor	According to the agreement with the Emperor, the soldiers of the regiments under the command of Morgan Bernhardt have the right to part of the trophies after the battles, and their commanders will receive titles and lands at the end of the campaign. In exchange, mercenaries will receive only half of their standard salary.	true
ui_unit_bullet_point_enums_onscreen_name_morgan_bernhardt	Led by Morgan Bernhardt 	true
ui_unit_bullet_point_enums_tooltip_morgan_bernhardt	Taking their name from their Commander's powerful sword 'Grudgebringer' these mercenaries form the core of the army known as the Grudgebringers. They are skilled in combat and ride into battle on mighty warhorses. 	true
ui_unit_bullet_point_enums_onscreen_name_willem_fletcher	Led by Willem Fletcher 	true
ui_unit_bullet_point_enums_tooltip_willem_fletcher	These mercenaries, all expert crossbowmen, have a disreputable past. They originally formed part of a small bandit army working in the forests of Talabecland. After a crackdown which was aided by elite Imperial forces they fled south to evade capture. Currently residing in the Border Princes town of Wissenheim, and still on the Empire's wanted list, they seek anonymity by joining a legitimate mercenary army.	true
ui_unit_bullet_point_enums_onscreen_name_azguz_bloodfist	Led by Azguz Bloodfist	true
ui_unit_bullet_point_enums_tooltip_azguz_bloodfist	Powerful dwarf hero	true
ui_unit_bullet_point_enums_onscreen_name_dargrimm_firebeard	Led by Dargrimm Firebeard	true
ui_unit_bullet_point_enums_tooltip_dargrimm_firebeard	Powerful dwarf hero	true
ui_unit_bullet_point_enums_onscreen_name_rune_weapon	Runic Weapon	true
ui_unit_bullet_point_enums_tooltip_rune_weapon	The hero is armed with runic weapons, forged by runesmiths	true
ui_unit_bullet_point_enums_onscreen_name_hero_led	Hero-Led	true
ui_unit_bullet_point_enums_tooltip_hero_led	This unit is led by a powerful hero.	true
ui_unit_bullet_point_enums_onscreen_name_golden_magus_djinn_skiff_bodyguards	Djinn Guardians	true
ui_unit_bullet_point_enums_tooltip_golden_magus_djinn_skiff_bodyguards	At a glance, the skiff may seem to be ineffective in battle, but it is protected by several Djinns who will fiercely defend their master.	true
ui_unit_bullet_point_enums_tooltip_battle_recipes	This character is able to alter the course of battle with his food recipes.... somehow.	true
ui_unit_bullet_point_enums_onscreen_name_battle_recipes	Battle Recipes	true
ui_unit_bullet_point_enums_onscreen_name_necromantic_anchor	Necromantic Anchor	true
ui_unit_bullet_point_enums_tooltip_necromantic_anchor	The towering frame of a skeletal giant can be seen far and wide on the battlefield. As such they are perfectly suited to serve as a conduit to channel the dark magic from the necromancer to his troops, anchoring them in the mortal world.	true
ui_unit_bullet_point_enums_onscreen_name_elo_only_bones	Only Bones	false
ui_unit_bullet_point_enums_tooltip_elo_only_bones	Skeletal Giants made from the dense bones of dead giants only. This makes them more resistant to small arms fire than their living counterparts.	false
ui_unit_bullet_point_enums_tooltip_horrible_stench	River Trolls stink horribly - even compared to other trolls. Even the most repulsive or strong-willed beings need to overcome their natural disgust to engage them in close combat.	true
ui_unit_bullet_point_enums_onscreen_name_horrible_stench	Horrible Stench	true
ui_unit_bullet_point_enums_tooltip_rock_solid	Stone Trolls have hard skin which makes them very resilient against physical or magical harm. However, once it is penetrated and the Trolls feel pain, they are easy to scare off the battlefield.	true
ui_unit_bullet_point_enums_onscreen_name_rock_solid	Stone Skin	true
ui_unit_bullet_point_enums_onscreen_name_death_stench	Stench of Death	true
ui_unit_bullet_point_enums_tooltip_death_stench	Other River Trolls already stink badly of rotting fish and riverbed, but Shipwreckers stink of rotting corpses, feces and waste. Even the bravest find it intolerable to stay close for long, let alone to fight efficiently.	true
ui_unit_bullet_point_enums_tooltip_throgg_orders	These Trolls have been under the bosses command for a very long time already. They can follow simple orders to slightly alter their behaviour in battle. Due to their limited intelligence though, only one order per battle can be given to avoid confusion.	true
ui_unit_bullet_point_enums_onscreen_name_throgg_orders	Bosses Orders	true
ui_unit_bullet_point_enums_onscreen_name_difficult_to_spot	Natural Camouflage	true
ui_unit_bullet_point_enums_tooltip_difficult_to_spot	Despite being naturally camouflaged in forests, these monsters never understood the concept of sneaking. They are still difficult to spot from afar.	true
ui_unit_bullet_point_enums_onscreen_name_weak_regeneration	Weakened Regeneration	true
ui_unit_bullet_point_enums_tooltip_weak_regeneration	The regenerative ability of Bile Trolls is mostly occupied by keeping their many afflictions at bay. This means that wounds Bile Trolls receive are healing much slower compared to other Trolls.	true
ui_unit_bullet_point_enums_onscreen_name_host_illnesses	Host to Terrifying Afflictions	true
ui_unit_bullet_point_enums_tooltip_host_illnesses	Just being near Bile Trolls is a terrifying experience as the many gifts of Grandfather Nurgle constantly threaten to infect everyone around, weakening and frightening closeby enemies and allies alike.	true
ui_unit_bullet_point_enums_onscreen_name_big_angry	Reckless Rage	true
ui_unit_bullet_point_enums_tooltip_big_angry	Hurting these Trolls just makes them really angry. Not even the boss can maintain control over enraged Snow Trolls - usually it is not necessary though, since they will just pound the source of their anger into the ground.	true
ui_unit_bullet_point_enums_tooltip_no_regeneration	The regenerative abilities of Lava Trolls are fully occupied, constantly repairing the damage the heat inside their bodies causes. These Trolls cannot regenerate damage received and heal as slowly as most 'normal' beings. 	true
ui_unit_bullet_point_enums_onscreen_name_no_regeneration	No Regeneration	true
ui_unit_bullet_point_enums_tooltip_burning_aura	Lava Trolls radiate heat. Those who come too close to engage these monsters in melee are often burned by their proximity to the Lava Trolls alone.	true
ui_unit_bullet_point_enums_onscreen_name_burning_aura	Burning Aura	true
ui_unit_bullet_point_enums_tooltip_warpstone_solid	Somehow Warpstone has fused to the skin of these creatures, making them resilient to all types of damage. And those who feel no pain will not retreat easily - at least as long as their protective shell persists.	true
ui_unit_bullet_point_enums_onscreen_name_warpstone_solid	Warpstone Infused Skin	true
ui_unit_bullet_point_enums_tooltip_contaminating_attacks	The weapons made of crude, unrefined warpstone cause weird, unnatural effects on closeby targets, greatly increasing their desire to avoid being engaged in combat with monsters wielding them.	true
ui_unit_bullet_point_enums_onscreen_name_contaminating_attacks	Contaminating Attacks	true
ui_unit_bullet_point_enums_tooltip_missile_weakness	This unit is weak to ranged missile fire.	true
ui_unit_bullet_point_enums_onscreen_name_missile_weakness	Missile Weakness	true
